Ql^Xo, Ql^Xo, Ql^Xo, Ql^Xo, Ql^Xo, Ql^Xo, Ql^Xo, Ql^Xo, Ql^Xo, Ql^Xo, Ql^Xo, Ql^Xo, Ql^Xo, Ql^Xo, Ql^Xo, Ql^Xo, Ql^Xo, Ql^Xo, Ql^Xo, Ql^Xo, Ql^Xo, Ql^Xo, Ql^Xo, Ql^Xo, Ql^Xo, Ql^Xo, Ql^Xo, Ql^Xo, Ql^Xo, Ql^Xo, Ql^Xo, Ql^Xo, Ql^Xo, Ql^Xo, Ql^Xo, Ql^Xo, Ql^Xo, Ql^Xo, Ql^Xo, Ql^Xo, Ql^Xo, Ql^Xo, Ql^Xo, Ql^Xo, Ql^Xo, Ql^Xo, Ql^Xo, Ql^Xo, Ql^Xo, Ql^Xo, Ql^Xo, Ql^Xo, Ql^Xo, Ql^Xo
Ql^Xo, Ql^Xo, Ql^Xo, Ql^Xo, Ql^Xo, Ql^Xo, Ql^Xo, Ql^Xo, Ql^Xo, Ql^Xo, Ql^Xo, Ql^Xo, Ql^Xo, Ql^Xo, Ql^Xo, Ql^Xo, Ql^Xo, Ql^Xo, Ql^Xo, Ql^Xo, Ql^Xo, Ql^Xo, Ql^Xo, Ql^Xo, Ql^Xo, Ql^Xo, Ql^Xo, Ql^Xo, Ql^Xo, Ql^Xo, Ql^Xo, Ql^Xo, Ql^Xo, Ql^Xo, Ql^Xo, Ql^Xo, Ql^Xo, Ql^Xo, Ql^Xo, Ql^Xo, Ql^Xo, Ql^Xo, Ql^Xo, Ql^Xo, Ql^Xo, Ql^Xo, Ql^Xo, Ql^Xo, Ql^Xo, Ql^Xo, Ql^Xo, Ql^Xo, Ql^Xo, Ql^Xo
Ql^Xo, Ql^Xo, Ql^Xo, Ql^Xo, Ql^Xo, Ql^Xo, Ql^Xo, Ql^Xo, Ql^Xo, Ql^Xo, Ql^Xo, Ql^Xo, Ql^Xo, Ql^Xo, Ql^Xo, Ql^Xo, Ql^Xo, Ql^Xo, Ql^Xo, Ql^Xo, Ql^Xo, Ql^Xo, Ql^Xo, Ql^Xo, Ql^Xo, Ql^Xo, Ql^Xo, Ql^Xo, Ql^Xo, Ql^Xo, Ql^Xo, Ql^Xo, Ql^Xo, Ql^Xo, Ql^Xo, Ql^Xo, Ql^Xo, Ql^Xo, Ql^Xo, Ql^Xo, Ql^Xo, Ql^Xo, Ql^Xo, Ql^Xo, Ql^Xo, Ql^Xo, Ql^Xo, Ql^Xo, Ql^Xo, Ql^Xo, Ql^Xo, Ql^Xo, Ql^Xo, Ql^Xo
Ql^Xo, Ql^Xo, Ql^Xo, Ql^Xo, Ql^Xo, Ql^Xo, Ql^Xo, Ql^Xo, Ql^Xo, Ql^Xo, Ql^Xo, Ql^Xo, Ql^Xo, Ql^Xo, Ql^Xo, Ql^Xo, Ql^Xo, Ql^Xo, Ql^Xo, Ql^Xo, Ql^Xo, Ql^Xo, Ql^Xo, Ql^Xo, Ql^Xo, Ql^Xo, Ql^Xo, Ql^Xo, Ql^Xo, Ql^Xo, Ql^Xo, Ql^Xo, Ql^Xo, Ql^Xo, Ql^Xo, Ql^Xo, Ql^Xo, Ql^Xo, Ql^Xo, Ql^Xo, Ql^Xo, Ql^Xo, Ql^Xo, Ql^Xo, Ql^Xo, Ql^Xo, Ql^Xo, Ql^Xo, Ql^Xo, Ql^Xo, Ql^Xo, Ql^Xo, Ql^Xo, Ql^Xo
Ql^Xo, Ql^Xo, Ql^Xo, Ql^Xo, Ql^Xo, Ql^Xo, Ql^Xo, Ql^Xo, Ql^Xo, Ql^Xo, Ql^Xo, Ql^Xo, Ql^Xo, Ql^Xo, Ql^Xo, Ql^Xo, Ql^Xo, Ql^Xo, Ql^Xo, Ql^Xo, Ql^Xo, Ql^Xo, Ql^Xo, Ql^Xo, Ql^Xo, Ql^Xo, Ql^Xo, Ql^Xo, Ql^Xo, Ql^Xo, Ql^Xo, Ql^Xo, Ql^Xo, Ql^Xo, Ql^Xo, Ql^Xo, Ql^Xo, Ql^Xo, Ql^Xo, Ql^Xo, Ql^Xo, Ql^Xo, Ql^Xo, Ql^Xo, Ql^Xo, Ql^Xo, Ql^Xo, Ql^Xo, Ql^Xo, Ql^Xo, Ql^Xo, Ql^Xo, Ql^Xo, Ql^Xo
Ql^Xo, Ql^Xo, Ql^Xo, Ql^Xo, Ql^Xo, Ql^Xo, Ql^Xo, Ql^Xo, Ql^Xo, Ql^Xo, Ql^Xo, Ql^Xo, Ql^Xo, Ql^Xo, Ql^Xo, Ql^Xo, Ql^Xo, Ql^Xo, Ql^Xo, Ql^Xo, Ql^Xo, Ql^Xo, Ql^Xo, Ql^Xo, Ql^Xo, Ql^Xo, Xos, Ql^Xo, Ql^Xo, Ql^Xo, Ql^Xo, Ql^Xo, Ql^Xo, Ql^Xo, Ql^Xo, Ql^Xo, Ql^Xo, Ql^Xo, Ql^Xo, Ql^Xo, Ql^Xo, Ql^Xo, Ql^Xo, Ql^Xo, Ql^Xo, Ql^Xo, Ql^Xo, Ql^Xo, Ql^Xo, Ql^Xo, Ql^Xo, Ql^Xo, Ql^Xo, Ql^Xo
Ql^Xo, Ql^Xo, Ql^Xo, Ql^Xo, Ql^Xo, Ql^Xo, Ql^Xo, Ql^Xo, Ql^Xo, Ql^Xo, Ql^Xo, Ql^Xo, Ql^Xo, Ql^Xo, Ql^Xo, Ql^Xo, Ql^Xo, Ql^Xo, Ql^Xo, Ql^Xo, Ql^Xo, Ql^Xo, Ql^Xo, Ql^Xo, Ql^Xo, Xos, Ql^Xo, Xos, Ql^Xo, Ql^Xo, Ql^Xo, Ql^Xo, Ql^Xo, Ql^Xo, Ql^Xo, Ql^Xo, Ql^Xo, Ql^Xo, Ql^Xo, Ql^Xo, Ql^Xo, Ql^Xo, Ql^Xo, Ql^Xo, Ql^Xo, Ql^Xo, Ql^Xo, Ql^Xo, Ql^Xo, Ql^Xo, Ql^Xo, Ql^Xo, Ql^Xo, Ql^Xo
Ql^Xo, Ql^Xo, Ql^Xo, Ql^Xo, Ql^Xo, Ql^Xo, Ql^Xo, Ql^Xo, Ql^Xo, Ql^Xo, Ql^Xo, Ql^Xo, Ql^Xo, Ql^Xo, Ql^Xo, Ql^Xo, Ql^Xo, Ql^Xo, Ql^Xo, Ql^Xo, Ql^Xo, Ql^Xo, Ql^Xo, Ql^Xo, Xos, Xos, Xos, Xos, Xos, Ql^Xo, Ql^Xo, Ql^Xo, Ql^Xo, Ql^Xo, Ql^Xo, Ql^Xo, Ql^Xo, Ql^Xo, Ql^Xo, Ql^Xo, Ql^Xo, Ql^Xo, Ql^Xo, Ql^Xo, Ql^Xo, Ql^Xo, Ql^Xo, Ql^Xo, Ql^Xo, Ql^Xo, Ql^Xo, Ql^Xo, Ql^Xo, Ql^Xo
Ql^Xo, Ql^Xo, Ql^Xo, Ql^Xo, Ql^Xo, Ql^Xo, Ql^Xo, Ql^Xo, Ql^Xo, Ql^Xo, Ql^Xo, Ql^Xo, Ql^Xo, Ql^Xo, Ql^Xo, Ql^Xo, Ql^Xo, Ql^Xo, Ql^Xo, Ql^Xo, Ql^Xo, Ql^Xo, Ql^Xo, Xos, Urb, Urb, Xos, Urb, Urb, Xos, Ql^Xo, Ql^Xo, Ql^Xo, Ql^Xo, Ql^Xo, Ql^Xo, Ql^Xo, Ql^Xo, Ql^Xo, Ql^Xo, Ql^Xo, Ql^Xo, Ql^Xo, Ql^Xo, Ql^Xo, Ql^Xo, Ql^Xo, Ql^Xo, Ql^Xo, Ql^Xo, Ql^Xo, Ql^Xo, Ql^Xo, Ql^Xo
Ql^Xo, Ql^Xo, Ql^Xo, Ql^Xo, Ql^Xo, Ql^Xo, Ql^Xo, Ql^Xo, Ql^Xo, Ql^Xo, Ql^Xo, Ql^Xo, Ql^Xo, Ql^Xo, Ql^Xo, Ql^Xo, Ql^Xo, Ql^Xo, Ql^Xo, Ql^Xo, Xos, Xos, Xos, Xos, Urb, Xos, Ql^Xo, Xos, Urb, Xos, Xos, Xos, Xos, Ql^Xo, Ql^Xo, Ql^Xo, Ql^Xo, Ql^Xo, Ql^Xo, Ql^Xo, Ql^Xo, Ql^Xo, Ql^Xo, Ql^Xo, Ql^Xo, Ql^Xo, Ql^Xo, Ql^Xo, Ql^Xo, Ql^Xo, Ql^Xo, Ql^Xo, Ql^Xo, Ql^Xo
Ql^Xo, Ql^Xo, Ql^Xo, Ql^Xo, Ql^Xo, Ql^Xo, Ql^Xo, Ql^Xo, Ql^Xo, Ql^Xo, Ql^Xo, Ql^Xo, Ql^Xo, Ql^Xo, Ql^Xo, Ql^Xo, Ql^Xo, Ql^Xo, Ql^Xo, Ql^Xo, Xos, Urb, Urb, Urb, Xos, Urb, Chr, Urb, Xos, Urb, Urb, Urb, Xos, Ql^Xo, Ql^Xo, Ql^Xo, Ql^Xo, Ql^Xo, Ql^Xo, Ql^Xo, Ql^Xo, Ql^Xo, Ql^Xo, Ql^Xo, Ql^Xo, Ql^Xo, Ql^Xo, Ql^Xo, Ql^Xo, Ql^Xo, Ql^Xo, Ql^Xo, Ql^Xo, Ql^Xo
Ql^Xo, Ql^Xo, Ql^Xo, Ql^Xo, Ql^Xo, Ql^Xo, Ql^Xo, Ql^Xo, Ql^Xo, Ql^Xo, Ql^Xo, Ql^Xo, Ql^Xo, Ql^Xo, Ql^Xo, Ql^Xo, Ql^Xo, Ql^Xo, Ql^Xo, Xos, Urb, Xos, Xos, Xos, Urb, Urb, Urb, Urb, Urb, Xos, Xos, Xos, Urb, Xos, Ql^Xo, Ql^Xo, Ql^Xo, Ql^Xo, Ql^Xo, Ql^Xo, Ql^Xo, Ql^Xo, Ql^Xo, Ql^Xo, Ql^Xo, Ql^Xo, Ql^Xo, Ql^Xo, Ql^Xo, Ql^Xo, Ql^Xo, Ql^Xo, Ql^Xo, Ql^Xo
Ql^Xo, Ql^Xo, Ql^Xo, Ql^Xo, Ql^Xo, Ql^Xo, Ql^Xo, Ql^Xo, Ql^Xo, Ql^Xo, Ql^Xo, Ql^Xo, Ql^Xo, Ql^Xo, Ql^Xo, Ql^Xo, Ql^Xo, Ql^Xo, Xos, Xos, Xos, Urb, Urb, Urb, Xos, Urb, Urb, Urb, Xos, Urb, Urb, Urb, Xos, Xos, Xos, Ql^Xo, Ql^Xo, Ql^Xo, Ql^Xo, Ql^Xo, Ql^Xo, Ql^Xo, Ql^Xo, Ql^Xo, Ql^Xo, Ql^Xo, Ql^Xo, Ql^Xo, Ql^Xo, Ql^Xo, Ql^Xo, Ql^Xo, Ql^Xo, Ql^Xo
Ql^Xo, Ql^Xo, Ql^Xo, Ql^Xo, Ql^Xo, Ql^Xo, Ql^Xo, Ql^Xo, Ql^Xo, Ql^Xo, Ql^Xo, Ql^Xo, Ql^Xo, Ql^Xo, Ql^Xo, Ql^Xo, Ql^Xo, Xos, Gd, Gd, Gd, Xos, Xos, Xos, Urb, Urb, Urb, Urb, Urb, Xos, Xos, Xos, Gd, Gd, Gd, Xos, Ql^Xo, Ql^Xo, Ql^Xo, Ql^Xo, Ql^Xo, Ql^Xo, Ql^Xo, Ql^Xo, Ql^Xo, Ql^Xo, Ql^Xo, Ql^Xo, Ql^Xo, Ql^Xo, Ql^Xo, Ql^Xo, Ql^Xo, Ql^Xo
_off^_usr, Ql^Xo, _off^_usr, Ql^Xo, _off^_usr, Ql^Xo, Gd, Ql^Xo, Gd, Ql^Xo, Gd, Ql^Xo, Gd, Ql^Xo, Hh, Ql^Xo, Hh, Xos, Gd, Gd, Gd^Fetd, Gs, Xos, Urb, Urb, Urb, Urb, Urb, Urb, Urb, Xos, Gs, Gd^Fetd, Gd, Gd, Xos, Hh, Ql^Xo, Hh, Ql^Xo, Gd, Ql^Xo, Gd, Ql^Xo, Gd, Ql^Xo, Gd, Ql^Xo, _off^_usr, Ql^Xo, _off^_usr, Ql^Xo, _off^_usr, Ql^Xo
_off^_usr, _off^_usr, _off^_usr, _off^_usr, _off^_usr, _off^_usr, Gg, Gg, Gs^Fds, Gg, Gg, Gg, Gg, Gg, Hh, Hh, Gg, Xos, Gg, Gg, Gg, Gg, Urb, Urb, Urb, Urb, Urb, Urb, Urb, Urb, Urb, Gg, Gg, Gg, Gg, Xos, Gg, Hh, Hh, Gg, Gg, Gg, Gg, Gg, Gs^Fds, Gg, Gg, _off^_usr, _off^_usr, _off^_usr, _off^_usr, _off^_usr, _off^_usr, _off^_usr
_off^_usr, _off^_usr, _off^_usr, _off^_usr, _off^_usr, _off^_usr, _off^_usr, Gs^Fds, Gs^Fds, Gs^Fds, Gg, Gg, Gg, Gg, Gg, Hh, Gg, Gg, Gg, Gg, Gg, Gg, Chr, Urb, Xos, Urb, Urb, Urb, Xos, Urb, Chr, Gg, Gg, Gg, Gg, Gg, Gg, Hh, Gg, Gg, Gg, Gg, Gg, Gs^Fds, Gs^Fds, Gs^Fds, _off^_usr, _off^_usr, _off^_usr, _off^_usr, _off^_usr, _off^_usr, _off^_usr, _off^_usr
_off^_usr, _off^_usr, _off^_usr, _off^_usr, _off^_usr, _off^_usr, _off^_usr, _off^_usr, _off^_usr, Gs^Fds, Gg, Gg, Hh, Hh, Hh, Gg, Gs^Fds, Gg, Wwf, Gg, Gg, Gg, Gg, Gg, Gg, Xos, Xos, Xos, Gg, Gg, Gg, Gg, Gg, Gg, Wwf, Gg, Gs^Fds, Gg, Hh, Hh, Hh, Gg, Gg, Gs^Fds, _off^_usr, _off^_usr, _off^_usr, _off^_usr, _off^_usr, _off^_usr, _off^_usr, _off^_usr, _off^_usr, _off^_usr
_off^_usr, _off^_usr, _off^_usr, _off^_usr, _off^_usr, _off^_usr, _off^_usr, _off^_usr, _off^_usr, _off^_usr, Gg, Hh, Mm, Mm, Hh, Gs^Fds, Gs^Fds, Wwf, Wwg, Wwg, Hh, Hh, Gg, Gg, Gg, Gg, _off^_usr, Gg, Gg, Gg, Gg, Hh, Hh, Wwg, Wwg, Wwf, Gs^Fds, Gs^Fds, Hh, Mm, Mm, Hh, Gg, _off^_usr, _off^_usr, _off^_usr, _off^_usr, _off^_usr, _off^_usr, _off^_usr, _off^_usr, _off^_usr, _off^_usr, _off^_usr
_off^_usr, _off^_usr, _off^_usr, _off^_usr, _off^_usr, _off^_usr, _off^_usr, _off^_usr, _off^_usr, _off^_usr, Gg, Hh, Mm, Hh, Gg^Ve, Gg, Gg, Wwf, Wwg, Gg, Gg, Gg, Gs^Fds, Hh, Gs^Fds, Gs^Fds, _off^_usr, Gs^Fds, Gs^Fds, Hh, Gs^Fds, Gg, Gg, Gg, Wwg, Wwf, Gg, Gg, Gg^Ve, Hh, Mm, Hh, Gg, _off^_usr, _off^_usr, _off^_usr, _off^_usr, _off^_usr, _off^_usr, _off^_usr, _off^_usr, _off^_usr, _off^_usr, _off^_usr
_off^_usr, _off^_usr, _off^_usr, _off^_usr, _off^_usr, _off^_usr, _off^_usr, _off^_usr, _off^_usr, _off^_usr, _off^_usr, Gg, Gg, Hh, Hh, Gs^Fds, Gs^Fds, Wwf, Wwf, Wwf, Wwg, Gs^Fds, Gs^Fds, Gs^Fds, Gs^Fds, Gs^Fds, _off^_usr, Gs^Fds, Gs^Fds, Gs^Fds, Gs^Fds, Gs^Fds, Wwg, Wwf, Wwf, Wwf, Gs^Fds, Gs^Fds, Hh, Hh, Gg, Gg, _off^_usr, _off^_usr, _off^_usr, _off^_usr, _off^_usr, _off^_usr, _off^_usr, _off^_usr, _off^_usr, _off^_usr, _off^_usr, _off^_usr
_off^_usr, _off^_usr, _off^_usr, _off^_usr, _off^_usr, _off^_usr, _off^_usr, _off^_usr, _off^_usr, _off^_usr, _off^_usr, Gs^Fds, Gg, Hh, Gs^Fds, Gs^Fds, Gg, Wwf, Wwf, Wwg, Wwg, Wwg, Wwf, Cv, Kv, Cv, _off^_usr, Cv, Kv, Cv, Wwf, Wwg, Wwg, Wwg, Wwf, Wwf, Gg, Gs^Fds, Gs^Fds, Hh, Gg, Gs^Fds, _off^_usr, _off^_usr, _off^_usr, _off^_usr, _off^_usr, _off^_usr, _off^_usr, _off^_usr, _off^_usr, _off^_usr, _off^_usr, _off^_usr
_off^_usr, _off^_usr, _off^_usr, _off^_usr, _off^_usr, _off^_usr, _off^_usr, _off^_usr, _off^_usr, _off^_usr, _off^_usr, Gs^Fds, Gs^Fds, Gg, Gg, Gg, Gs^Fds, Wwf, Wwf, Wwg, Wwf, Wwg, Wwf, Cv, Cv, Cv, _off^_usr, Cv, Cv, Cv, Wwf, Wwg, Wwf, Wwg, Wwf, Wwf, Gs^Fds, Gg, Gg, Gg, Gs^Fds, Gs^Fds, _off^_usr, _off^_usr, _off^_usr, _off^_usr, _off^_usr, _off^_usr, _off^_usr, _off^_usr, _off^_usr, _off^_usr, _off^_usr, _off^_usr
_off^_usr, _off^_usr, _off^_usr, _off^_usr, _off^_usr, _off^_usr, _off^_usr, _off^_usr, _off^_usr, _off^_usr, _off^_usr, _off^_usr, _off^_usr, Gs^Fds, Gg^Ve, Gg, Gg, Gg^Fet, Wwf, Wwf, Wwf, Wwf, Wwf, Gs^Fds, Gs^Fds, Gs^Fds, _off^_usr, Gs^Fds, Gs^Fds, Gs^Fds, Wwf, Wwf, Wwf, Wwf, Wwf, Gg^Fet, Gg, Gg, Gg^Ve, Gs^Fds, _off^_usr, _off^_usr, _off^_usr, _off^_usr, _off^_usr, _off^_usr, _off^_usr, _off^_usr, _off^_usr, _off^_usr, _off^_usr, _off^_usr, _off^_usr, _off^_usr
_off^_usr, _off^_usr, _off^_usr, _off^_usr, _off^_usr, _off^_usr, _off^_usr, _off^_usr, _off^_usr, _off^_usr, _off^_usr, _off^_usr, _off^_usr, _off^_usr, _off^_usr, Gg, Gg, Gs^Fds, Hh, Hh, Hh, Hh, Wwf, Wwg, Wwg, Wwg, _off^_usr, Wwg, Wwg, Wwg, Wwf, Hh, Hh, Hh, Hh, Gs^Fds, Gg, Gg, _off^_usr, _off^_usr, _off^_usr, _off^_usr, _off^_usr, _off^_usr, _off^_usr, _off^_usr, _off^_usr, _off^_usr, _off^_usr, _off^_usr, _off^_usr, _off^_usr, _off^_usr, _off^_usr
_off^_usr, _off^_usr, _off^_usr, _off^_usr, _off^_usr, _off^_usr, _off^_usr, _off^_usr, _off^_usr, _off^_usr, _off^_usr, _off^_usr, _off^_usr, _off^_usr, _off^_usr, Gs^Fds, Gg, Gg, Gs, Gs, Gs^Fds, Gs^Fds, Gs, Wwf, Gs^Fds, Gs^Fds, _off^_usr, Gs^Fds, Gs^Fds, Wwf, Gs, Gs^Fds, Gs^Fds, Gs, Gs, Gg, Gg, Gs^Fds, _off^_usr, _off^_usr, _off^_usr, _off^_usr, _off^_usr, _off^_usr, _off^_usr, _off^_usr, _off^_usr, _off^_usr, _off^_usr, _off^_usr, _off^_usr, _off^_usr, _off^_usr, _off^_usr
_off^_usr, _off^_usr, _off^_usr, _off^_usr, _off^_usr, _off^_usr, _off^_usr, _off^_usr, _off^_usr, _off^_usr, _off^_usr, _off^_usr, _off^_usr, _off^_usr, _off^_usr, Gs^Fds, Gs^Fds, Gs^Fds, Wwf, Wwf, Wwf, Gs, Wwf, Wwf, Ss, Ss, _off^_usr, Ss, Ss, Wwf, Wwf, Gs, Wwf, Wwf, Wwf, Gs^Fds, Gs^Fds, Gs^Fds, _off^_usr, _off^_usr, _off^_usr, _off^_usr, _off^_usr, _off^_usr, _off^_usr, _off^_usr, _off^_usr, _off^_usr, _off^_usr, _off^_usr, _off^_usr, _off^_usr, _off^_usr, _off^_usr
_off^_usr, _off^_usr, _off^_usr, _off^_usr, _off^_usr, _off^_usr, _off^_usr, _off^_usr, _off^_usr, _off^_usr, _off^_usr, _off^_usr, _off^_usr, _off^_usr, _off^_usr, _off^_usr, Wwf, Wwf, Hh, Hh, Gs, Wwf, Ss, Ss, Ss, Ss, _off^_usr, Ss, Ss, Ss, Ss, Wwf, Gs, Hh, Hh, Wwf, Wwf, _off^_usr, _off^_usr, _off^_usr, _off^_usr, _off^_usr, _off^_usr, _off^_usr, _off^_usr, _off^_usr, _off^_usr, _off^_usr, _off^_usr, _off^_usr, _off^_usr, _off^_usr, _off^_usr, _off^_usr
_off^_usr, _off^_usr, _off^_usr, _off^_usr, _off^_usr, _off^_usr, _off^_usr, _off^_usr, _off^_usr, _off^_usr, _off^_usr, _off^_usr, _off^_usr, _off^_usr, _off^_usr, _off^_usr, Wwf, Wwf, Wwf, Hh, Gs, Gs^Fds, Gs, Ss, Ss, Ss, _off^_usr, Ss, Ss, Ss, Gs, Gs^Fds, Gs, Hh, Wwf, Wwf, Wwf, _off^_usr, _off^_usr, _off^_usr, _off^_usr, _off^_usr, _off^_usr, _off^_usr, _off^_usr, _off^_usr, _off^_usr, _off^_usr, _off^_usr, _off^_usr, _off^_usr, _off^_usr, _off^_usr, _off^_usr
_off^_usr, _off^_usr, _off^_usr, _off^_usr, _off^_usr, _off^_usr, _off^_usr, _off^_usr, _off^_usr, _off^_usr, _off^_usr, _off^_usr, _off^_usr, _off^_usr, Xu, Wwf, Wwf, Xu, Wwf, Gs^Fds, Gs^Fds, Gs, Ur, Ss, Ss, Ss, _off^_usr, Ss, Ss, Ss, Ur, Gs, Gs^Fds, Gs^Fds, Wwf, Xu, Wwf, Wwf, Xu, _off^_usr, _off^_usr, _off^_usr, _off^_usr, _off^_usr, _off^_usr, _off^_usr, _off^_usr, _off^_usr, _off^_usr, _off^_usr, _off^_usr, _off^_usr, _off^_usr, _off^_usr
_off^_usr, _off^_usr, _off^_usr, _off^_usr, _off^_usr, _off^_usr, _off^_usr, _off^_usr, _off^_usr, _off^_usr, _off^_usr, _off^_usr, _off^_usr, _off^_usr, Xu, Wwf, Wwf, Wwf, Xu, Uu, Uu, Ur, Ur, Uu, Uh, Xu, _off^_usr, Xu, Uh, Uu, Ur, Ur, Uu, Uu, Xu, Wwf, Wwf, Wwf, Xu, _off^_usr, _off^_usr, _off^_usr, _off^_usr, _off^_usr, _off^_usr, _off^_usr, _off^_usr, _off^_usr, _off^_usr, _off^_usr, _off^_usr, _off^_usr, _off^_usr, _off^_usr
_off^_usr, _off^_usr, _off^_usr, _off^_usr, _off^_usr, _off^_usr, _off^_usr, _off^_usr, _off^_usr, _off^_usr, _off^_usr, _off^_usr, _off^_usr, _off^_usr, Xu, Wwf, Wwf, Xu, Xu, Uh, Uu^Vud, Ur, Ur, Uu^Uf, Cud, Xu, _off^_usr, Xu, Cud, Uu^Uf, Ur, Ur, Uu^Vud, Uh, Xu, Xu, Wwf, Wwf, Xu, _off^_usr, _off^_usr, _off^_usr, _off^_usr, _off^_usr, _off^_usr, _off^_usr, _off^_usr, _off^_usr, _off^_usr, _off^_usr, _off^_usr, _off^_usr, _off^_usr, _off^_usr
_off^_usr, _off^_usr, _off^_usr, _off^_usr, _off^_usr, _off^_usr, _off^_usr, _off^_usr, _off^_usr, _off^_usr, _off^_usr, _off^_usr, Xu, Xu, Uh, Uu, Qxu, Uh, Cud, Uu^Br/, Uu^Br\, Ur, Ur, Cud, Kud, Xu, _off^_usr, Xu, Kud, Cud, Ur, Ur, Uu^Br/, Uu^Br\, Cud, Uh, Qxu, Uu, Uh, Xu, Xu, _off^_usr, _off^_usr, _off^_usr, _off^_usr, _off^_usr, _off^_usr, _off^_usr, _off^_usr, _off^_usr, _off^_usr, _off^_usr, _off^_usr, _off^_usr
_off^_usr, _off^_usr, _off^_usr, _off^_usr, _off^_usr, _off^_usr, _off^_usr, _off^_usr, _off^_usr, _off^_usr, Xu, Xu, Uu^Uf, Uh, Qxu, Qxu, Xu, Qxu, Uu^Vud, Uu, Uu^Br|, Ur, Ur, Cud, Cud, Xu, _off^_usr, Xu, Cud, Cud, Ur, Ur, Uu^Br|, Uu, Uu^Vud, Qxu, Xu, Qxu, Qxu, Uh, Uu^Uf, Xu, Xu, _off^_usr, _off^_usr, _off^_usr, _off^_usr, _off^_usr, _off^_usr, _off^_usr, _off^_usr, _off^_usr, _off^_usr, _off^_usr
_off^_usr, _off^_usr, _off^_usr, _off^_usr, _off^_usr, _off^_usr, _off^_usr, _off^_usr, _off^_usr, _off^_usr, Xu, Uu^Vu, Uu, Xu, Xu, Xu, Uu, Qxu, Qxu^Br/, Ur^Br/, Ur, Ur, Uu^Uf, Uu, Xu, Xu, _off^_usr, Xu, Xu, Uu, Uu^Uf, Ur, Ur, Ur^Br\, Qxu^Br\, Qxu, Uu, Xu, Xu, Xu, Uu, Uu^Vu, Xu, _off^_usr, _off^_usr, _off^_usr, _off^_usr, _off^_usr, _off^_usr, _off^_usr, _off^_usr, _off^_usr, _off^_usr, _off^_usr
_off^_usr, _off^_usr, _off^_usr, _off^_usr, _off^_usr, _off^_usr, _off^_usr, _off^_usr, _off^_usr, _off^_usr, _off^_usr, Xu, Uu, Xu, Xu, Ur, Ur^Br/, Ur^Br/, Qxu, Qxu, Xu, Ur, Uh, Uh, Xu, _off^_usr, _off^_usr, _off^_usr, Xu, Uh, Uh, Ur, Xu, Qxu, Qxu, Ur^Br\, Ur^Br\, Ur, Xu, Xu, Uu, Xu, _off^_usr, _off^_usr, _off^_usr, _off^_usr, _off^_usr, _off^_usr, _off^_usr, _off^_usr, _off^_usr, _off^_usr, _off^_usr, _off^_usr
_off^_usr, _off^_usr, _off^_usr, _off^_usr, _off^_usr, _off^_usr, _off^_usr, _off^_usr, _off^_usr, _off^_usr, Xu, Xu, Xu, Uu, Ur^Br/, Ur^Br/, Uh, Uh, Uh, Qxu, Xu, Uh, Xu, Xu, _off^_usr, _off^_usr, _off^_usr, _off^_usr, _off^_usr, Xu, Xu, Uh, Xu, Uh, Uh, Uh, Uh, Ur^Br\, Ur^Br|, Uu, Xu, Xu, Xu, _off^_usr, _off^_usr, _off^_usr, _off^_usr, _off^_usr, _off^_usr, _off^_usr, _off^_usr, _off^_usr, _off^_usr, _off^_usr
_off^_usr, _off^_usr, _off^_usr, _off^_usr, _off^_usr, _off^_usr, _off^_usr, _off^_usr, _off^_usr, Xu, Ur, Ur, Ur, Xu, Ur^Br|, Ur, Uu^Uf, Uh, Uh, Xu, Uu, Xu, _off^_usr, _off^_usr, _off^_usr, _off^_usr, _off^_usr, _off^_usr, _off^_usr, _off^_usr, _off^_usr, Xu, Uu, Xu, Uh, Uh, Uu^Uf, Ur, Ur^Br|, Xu, Ur, Ur, Ur, Xu, _off^_usr, _off^_usr, _off^_usr, _off^_usr, _off^_usr, _off^_usr, _off^_usr, _off^_usr, _off^_usr, _off^_usr
_off^_usr, _off^_usr, _off^_usr, _off^_usr, _off^_usr, _off^_usr, _off^_usr, _off^_usr, Xu, Xu, Xu, Ur, Xu, Xu, Uu^Br|, Ur, Ur, Xu, Xu, Xu, Wwf, Xu, Xu, _off^_usr, _off^_usr, _off^_usr, _off^_usr, _off^_usr, _off^_usr, _off^_usr, Xu, Xu, Wwf, Xu, Xu, Xu, Ur, Ur, Uu^Br|, Xu, Xu, Ur, Xu, Xu, Xu, _off^_usr, _off^_usr, _off^_usr, _off^_usr, _off^_usr, _off^_usr, _off^_usr, _off^_usr, _off^_usr
_off^_usr, _off^_usr, _off^_usr, _off^_usr, _off^_usr, _off^_usr, Xu, Xu, Cud, Uu^Vud, Ur, Ur, Ur, Xu, Uu^Br|, Ur, Ur, Xu, Uu, Wwf, Xu, Wwf, Wwf, Xu, Xu, _off^_usr, _off^_usr, _off^_usr, Xu, Xu, Wwf, Wwf, Xu, Wwf, Uu, Xu, Ur, Ur, Uu^Br|, Xu, Ur, Ur, Ur, Uu^Vud, Cud, Xu, Xu, _off^_usr, _off^_usr, _off^_usr, _off^_usr, _off^_usr, _off^_usr, _off^_usr
_off^_usr, _off^_usr, _off^_usr, _off^_usr, _off^_usr, _off^_usr, Xu, Kud, Cud, Ur, Uu, Uu, Ur, Uu, Cud, Ur, Xu, Xu, Xu, Xu, Ur, Xu, Wwf, Wwg, Wwg, Xu, _off^_usr, Xu, Wwg, Wwg, Wwf, Xu, Ur, Xu, Xu, Xu, Xu, Ur, Cud, Uu, Ur, Uu, Uu, Ur, Cud, Kud, Xu, _off^_usr, _off^_usr, _off^_usr, _off^_usr, _off^_usr, _off^_usr, _off^_usr
_off^_usr, _off^_usr, _off^_usr, _off^_usr, Xu, Xu, Cud, Cud, Ur, Ur, Xu, Uh, Uu^Uf, Ur, Ur, Ur, Uu, Uh, Qxu, Ur, Wwf, Wwf, Xu, Wwf, Wwf, Xu, _off^_usr, Xu, Wwf, Wwf, Xu, Wwf, Wwf, Ur, Qxu, Uh, Uu, Ur, Ur, Ur, Uu^Uf, Uh, Xu, Ur, Ur, Cud, Cud, Xu, Xu, _off^_usr, _off^_usr, _off^_usr, _off^_usr, _off^_usr
_off^_usr, _off^_usr, _off^_usr, Xu, Uu, Uu, Ur, Uu, Ur, Uu, Xu, Uh, Xu, Xu, Xu, Ur, Uu^Ufi, Uh, Wwf, Wwf, Xu, Xu, Wwf, Wwf, Wwg, Xu, _off^_usr, Xu, Wwg, Wwf, Wwf, Xu, Xu, Wwf, Wwf, Uh, Uu^Ufi, Ur, Xu, Xu, Xu, Uh, Xu, Uu, Ur, Uu, Ur, Uu, Uu, Xu, _off^_usr, _off^_usr, _off^_usr, _off^_usr
_off^_usr, _off^_usr, _off^_usr, Xu, Xu, Ur, Ur, Ur, Uu, Uh, Uh, Xu, Mm, Mm, Xu, Ur, Ur, Ur, Xu, Wwf, Xu, Wwf, Wwg, Wwg, Md, Md, _off^_usr, Md, Md, Wwg, Wwg, Wwf, Xu, Wwf, Xu, Ur, Ur, Ur, Xu, Mm, Mm, Xu, Uh, Uh, Uu, Ur, Ur, Ur, Xu, Xu, _off^_usr, _off^_usr, _off^_usr, _off^_usr
_off^_usr, _off^_usr, _off^_usr, _off^_usr, Xu, Uu^Uf, Ur, Uu, Uu^Uf, Uu, Xu, Xu, Mm, Mm, Mm, Xu, Xu, Xu, Hh, Xu, Wwf, Wwf, Wwg, Wwg, Wwg, Md, _off^_usr, Md, Wwg, Wwg, Wwg, Wwf, Wwf, Xu, Hh, Xu, Xu, Xu, Mm, Mm, Mm, Xu, Xu, Uu, Uu^Uf, Uu, Ur, Uu^Uf, Xu, _off^_usr, _off^_usr, _off^_usr, _off^_usr, _off^_usr
_off^_usr, _off^_usr, _off^_usr, _off^_usr, _off^_usr, Xu, Xu, Ur, Ur, Xu, Hh^Vhh, Hh, Hh, Gs^Fms, Gs^Fms, Hh, Hh, Hh^Vhh, Hh, Gs, Wwf, Wwf, Wwf, Wwg, Wwg, Wwg, _off^_usr, Wwg, Wwg, Wwg, Wwf, Wwf, Wwf, Gs, Hh, Hh^Vhh, Hh, Hh, Gs^Fms, Gs^Fms, Hh, Hh, Hh^Vhh, Xu, Ur, Ur, Xu, Xu, _off^_usr, _off^_usr, _off^_usr, _off^_usr, _off^_usr, _off^_usr
_off^_usr, _off^_usr, _off^_usr, _off^_usr, _off^_usr, _off^_usr, Xu, Re, Gd, Mm, Gll^Fmf, Md, Md, Md, Md, Gs^Fms, Hh, Hh, Gs, Gs, Gd, Re, Gll^Fmf, Wwf, Wwg, Wwg, _off^_usr, Wwg, Wwg, Wwf, Gll^Fmf, Re, Gd, Gs, Gs, Hh, Hh, Gs^Fms, Md, Md, Md, Md, Gll^Fmf, Mm, Gd, Re, Xu, _off^_usr, _off^_usr, _off^_usr, _off^_usr, _off^_usr, _off^_usr, _off^_usr
_off^_usr, _off^_usr, _off^_usr, _off^_usr, _off^_usr, _off^_usr, Xu, Md, Gd, Gll^Fmf, Gd, Gll^Fmf, Md, Md, Hhd, Gs^Fms, Gs^Fms, Gd, Gd, Gd, Re, Re, Wwg, Wwg, Wwg, Wwg, _off^_usr, Wwg, Wwg, Wwg, Wwg, Re, Re, Gd, Gd, Gd, Gs^Fms, Gs^Fms, Hhd, Md, Md, Gll^Fmf, Gd, Gll^Fmf, Gd, Md, Xu, _off^_usr, _off^_usr, _off^_usr, _off^_usr, _off^_usr, _off^_usr, _off^_usr
_off^_usr, _off^_usr, _off^_usr, _off^_usr, _off^_usr, _off^_usr, _off^_usr, Md, Gd, Gll, Gll^Fdf, Gd, Gd, Gd, Hhd, Hhd, Hhd, Gll^Fmf, Gll^Fmf, Re, Wwf, Wwf, Wwg, Wwg, Hhd, Hhd, _off^_usr, Hhd, Hhd, Wwg, Wwg, Wwf, Wwf, Re, Gll^Fmf, Gll^Fmf, Hhd, Hhd, Hhd, Gd, Gd, Gd, Gll^Fdf, Gll, Gd, Md, _off^_usr, _off^_usr, _off^_usr, _off^_usr, _off^_usr, _off^_usr, _off^_usr, _off^_usr
_off^_usr, _off^_usr, _off^_usr, _off^_usr, _off^_usr, _off^_usr, _off^_usr, _off^_usr, _off^_usr, Gll, Gll, Gll^Fdf, Gll^Fdf, Gll^Fdf, Wwg, Wwg, Wwg, Gll^Fmf, Wwg, Re, Re, Hhd, Hhd, Hhd, Md, Md, _off^_usr, Md, Md, Hhd, Hhd, Hhd, Re, Re, Wwg, Gll^Fmf, Wwg, Wwg, Wwg, Gll^Fdf, Gll^Fdf, Gll^Fdf, Gll, Gll, _off^_usr, _off^_usr, _off^_usr, _off^_usr, _off^_usr, _off^_usr, _off^_usr, _off^_usr, _off^_usr, _off^_usr
_off^_usr, _off^_usr, _off^_usr, _off^_usr, _off^_usr, _off^_usr, _off^_usr, _off^_usr, _off^_usr, _off^_usr, _off^_usr, Gll, Gll, Hhd, Wwg, Hhd, Hhd, Wwg, Ke, Ce, Gll^Fdf, Re, Re, Gll^Fmf, Gll^Fmf, Gll^Fmf, _off^_usr, Gll^Fmf, Gll^Fmf, Gll^Fmf, Re, Re, Gll^Fdf, Ce, Ke, Wwg, Hhd, Hhd, Wwg, Hhd, Gll, Gll, _off^_usr, _off^_usr, _off^_usr, _off^_usr, _off^_usr, _off^_usr, _off^_usr, _off^_usr, _off^_usr, _off^_usr, _off^_usr, _off^_usr
_off^_usr, _off^_usr, _off^_usr, _off^_usr, _off^_usr, _off^_usr, _off^_usr, _off^_usr, _off^_usr, _off^_usr, _off^_usr, _off^_usr, Gll^Fdf, Gll, Gll^Fdf, Gll, Hhd, Wwg, Wwg, Ce, Ce, Gll^Fdf, Rb, Gll, Gll^Fdf, Gll, _off^_usr, Gll, Gll^Fdf, Gll, Rb, Gll^Fdf, Ce, Ce, Wwg, Wwg, Hhd, Gll, Gll^Fdf, Gll, Gll^Fdf, _off^_usr, _off^_usr, _off^_usr, _off^_usr, _off^_usr, _off^_usr, _off^_usr, _off^_usr, _off^_usr, _off^_usr, _off^_usr, _off^_usr, _off^_usr
_off^_usr, _off^_usr, _off^_usr, _off^_usr, _off^_usr, _off^_usr, _off^_usr, _off^_usr, _off^_usr, _off^_usr, _off^_usr, _off^_usr, Gll^Fdf, Gll^Fdf, Hhd, Gll^Fdf, Md, Wwf, Hhd, Wwg, Wwf, Wwf, Wwg, Wwg, Gll^Fdf, Gll^Fdf, _off^_usr, Gll^Fdf, Gll^Fdf, Wwg, Wwg, Wwf, Wwf, Wwg, Hhd, Wwf, Md, Gll^Fdf, Hhd, Gll^Fdf, Gll^Fdf, _off^_usr, _off^_usr, _off^_usr, _off^_usr, _off^_usr, _off^_usr, _off^_usr, _off^_usr, _off^_usr, _off^_usr, _off^_usr, _off^_usr, _off^_usr
_off^_usr, _off^_usr, _off^_usr, _off^_usr, _off^_usr, _off^_usr, _off^_usr, _off^_usr, _off^_usr, _off^_usr, _off^_usr, _off^_usr, Hhd, Wwf, Wwf, Hhd, Hhd, Hhd, Gll^Fdf, Hhd, Wwf, Wwg, Wwg, Wwg, Hhd^Vhhr, Gll^Fdf, _off^_usr, Gll^Fdf, Hhd^Vhhr, Wwg, Wwg, Wwg, Wwf, Hhd, Gll^Fdf, Hhd, Hhd, Hhd, Wwf, Wwf, Hhd, _off^_usr, _off^_usr, _off^_usr, _off^_usr, _off^_usr, _off^_usr, _off^_usr, _off^_usr, _off^_usr, _off^_usr, _off^_usr, _off^_usr, _off^_usr
_off^_usr, _off^_usr, _off^_usr, _off^_usr, _off^_usr, _off^_usr, _off^_usr, _off^_usr, _off^_usr, _off^_usr, _off^_usr, _off^_usr, Hhd^Vhhr, Md, Md, Wwf, Wwf, Wwf, Wwf, Hhd, Gd, Wwf, Hhd, Hhd, Md, Md, _off^_usr, Md, Md, Hhd, Hhd, Wwf, Gd, Hhd, Wwf, Wwf, Wwf, Wwf, Md, Md, Hhd^Vhhr, _off^_usr, _off^_usr, _off^_usr, _off^_usr, _off^_usr, _off^_usr, _off^_usr, _off^_usr, _off^_usr, _off^_usr, _off^_usr, _off^_usr, _off^_usr
_off^_usr, _off^_usr, _off^_usr, _off^_usr, _off^_usr, _off^_usr, _off^_usr, _off^_usr, _off^_usr, _off^_usr, _off^_usr, _off^_usr, Md, Md, Hhd, Hhd, Hhd, Hhd, Wwg, Hhd, Gd, Gll^Fdf, Gll^Fdf, Gd, Md, Md^Xm, _off^_usr, Md^Xm, Md, Gd, Gll^Fdf, Gll^Fdf, Gd, Hhd, Wwg, Hhd, Hhd, Hhd, Hhd, Md, Md, _off^_usr, _off^_usr, _off^_usr, _off^_usr, _off^_usr, _off^_usr, _off^_usr, _off^_usr, _off^_usr, _off^_usr, _off^_usr, _off^_usr, _off^_usr
_off^_usr, _off^_usr, _off^_usr, _off^_usr, _off^_usr, _off^_usr, _off^_usr, _off^_usr, _off^_usr, _off^_usr, _off^_usr, _off^_usr, Hhd, Gll^Fmf, Hhd, Md, Hhd, Wwg, Wwg, Wwg, Gd, Gll^Fdf, Hhd, Gll^Fdf, Gd, Hhd, _off^_usr, Hhd, Gd, Gll^Fdf, Hhd, Gll^Fdf, Gd, Wwg, Wwg, Wwg, Hhd, Md, Hhd, Gll^Fmf, Hhd, _off^_usr, _off^_usr, _off^_usr, _off^_usr, _off^_usr, _off^_usr, _off^_usr, _off^_usr, _off^_usr, _off^_usr, _off^_usr, _off^_usr, _off^_usr
_off^_usr, _off^_usr, _off^_usr, _off^_usr, _off^_usr, _off^_usr, _off^_usr, _off^_usr, _off^_usr, _off^_usr, _off^_usr, _off^_usr, _off^_usr, Gd, Gd, Hhd, Wwg, Wwg, Wwg, Wwg, Wwf, Gd, Md, Hhd, Gll^Fmf, Hhd, _off^_usr, Hhd, Gll^Fmf, Hhd, Md, Gd, Wwf, Wwg, Wwg, Wwg, Wwg, Hhd, Gd, Gd, _off^_usr, _off^_usr, _off^_usr, _off^_usr, _off^_usr, _off^_usr, _off^_usr, _off^_usr, _off^_usr, _off^_usr, _off^_usr, _off^_usr, _off^_usr, _off^_usr
_off^_usr, _off^_usr, _off^_usr, _off^_usr, _off^_usr, _off^_usr, _off^_usr, _off^_usr, _off^_usr, _off^_usr, _off^_usr, _off^_usr, _off^_usr, Gll, Gll, Gd, Wwg, Wwg, Wwg, Wwg, Rb, Wwf, Gd, Gll^Fmw, Aa^Fpa, Gll^Fdw, _off^_usr, Gll^Fdw, Aa^Fpa, Gll^Fmw, Gd, Wwf, Rb, Wwg, Wwg, Wwg, Wwg, Gd, Gll, Gll, _off^_usr, _off^_usr, _off^_usr, _off^_usr, _off^_usr, _off^_usr, _off^_usr, _off^_usr, _off^_usr, _off^_usr, _off^_usr, _off^_usr, _off^_usr, _off^_usr
_off^_usr, _off^_usr, _off^_usr, _off^_usr, _off^_usr, _off^_usr, _off^_usr, _off^_usr, _off^_usr, _off^_usr, _off^_usr, _off^_usr, _off^_usr, Gll^Fdw, Aa^Fma, Gd, Gd, Wwg, Gll, Wwf, Gll^Fmw, Gll^Fmw, Ha, Aa, Ha, Aa^Fma, _off^_usr, Aa^Fma, Ha, Aa, Ha, Gll^Fmw, Gll^Fmw, Wwf, Gll, Wwg, Gd, Gd, Aa^Fma, Gll^Fdw, _off^_usr, _off^_usr, _off^_usr, _off^_usr, _off^_usr, _off^_usr, _off^_usr, _off^_usr, _off^_usr, _off^_usr, _off^_usr, _off^_usr, _off^_usr, _off^_usr
_off^_usr, _off^_usr, _off^_usr, _off^_usr, _off^_usr, _off^_usr, _off^_usr, _off^_usr, _off^_usr, _off^_usr, _off^_usr, _off^_usr, _off^_usr, Aa^Fma, Rb, Aa, Rb, Rb, Aa^Fpa, Gll, Aa^Fma, Ha^Vhha, Ms, Ms, Aa, Ms, _off^_usr, Ms, Aa, Ms, Ms, Ha^Vhha, Aa^Fma, Gll, Aa^Fpa, Rb, Rb, Aa, Rb, Aa^Fma, _off^_usr, _off^_usr, _off^_usr, _off^_usr, _off^_usr, _off^_usr, _off^_usr, _off^_usr, _off^_usr, _off^_usr, _off^_usr, _off^_usr, _off^_usr, _off^_usr
_off^_usr, _off^_usr, _off^_usr, _off^_usr, _off^_usr, _off^_usr, _off^_usr, _off^_usr, _off^_usr, _off^_usr, _off^_usr, _off^_usr, _off^_usr, Rb, Gd, Gd, Gd, Rb, Aa, Ha, Ha, Aa^Fma, Rb, Aa^Fpa, Gll^Fdw, Aa, _off^_usr, Aa, Gll^Fdw, Aa^Fpa, Rb, Aa^Fma, Ha, Ha, Aa, Rb, Gd, Gd, Gd, Rb, _off^_usr, _off^_usr, _off^_usr, _off^_usr, _off^_usr, _off^_usr, _off^_usr, _off^_usr, _off^_usr, _off^_usr, _off^_usr, _off^_usr, _off^_usr, _off^_usr
_off^_usr, _off^_usr, _off^_usr, _off^_usr, _off^_usr, _off^_usr, _off^_usr, _off^_usr, _off^_usr, _off^_usr, _off^_usr, _off^_usr, _off^_usr, Wwf, Wwf, Gd, Wwf, Rb, Rb, Ha, Aa, Aa^Fda, Rb, Rb, Gd, Gll^Fdw, _off^_usr, Gll^Fdw, Gd, Rb, Rb, Aa^Fda, Aa, Ha, Rb, Rb, Wwf, Gd, Wwf, Wwf, _off^_usr, _off^_usr, _off^_usr, _off^_usr, _off^_usr, _off^_usr, _off^_usr, _off^_usr, _off^_usr, _off^_usr, _off^_usr, _off^_usr, _off^_usr, _off^_usr
_off^_usr, _off^_usr, _off^_usr, _off^_usr, _off^_usr, _off^_usr, _off^_usr, _off^_usr, _off^_usr, _off^_usr, _off^_usr, _off^_usr, _off^_usr, Wwf, Ai, Wwf, Wwf, Wwf, Rb, Rb, Gll^Fdw, Rb, Aa, Aa, Ai, Wwf, _off^_usr, Wwf, Ai, Aa, Aa, Rb, Gll^Fdw, Rb, Rb, Wwf, Wwf, Wwf, Ai, Wwf, _off^_usr, _off^_usr, _off^_usr, _off^_usr, _off^_usr, _off^_usr, _off^_usr, _off^_usr, _off^_usr, _off^_usr, _off^_usr, _off^_usr, _off^_usr, _off^_usr
_off^_usr, _off^_usr, _off^_usr, _off^_usr, _off^_usr, _off^_usr, _off^_usr, _off^_usr, _off^_usr, _off^_usr, _off^_usr, _off^_usr, _off^_usr, Ms, Ha^Vhha, Ai, Aa^Fpa, Gll, Gll, Gll^Fdw, Gd, Rb, Rb, Wwf, Wwf, Wwf, _off^_usr, Wwf, Wwf, Wwf, Rb, Rb, Gd, Gll^Fdw, Gll, Gll, Aa^Fpa, Ai, Ha^Vhha, Ms, _off^_usr, _off^_usr, _off^_usr, _off^_usr, _off^_usr, _off^_usr, _off^_usr, _off^_usr, _off^_usr, _off^_usr, _off^_usr, _off^_usr, _off^_usr, _off^_usr
_off^_usr, _off^_usr, _off^_usr, _off^_usr, _off^_usr, _off^_usr, _off^_usr, _off^_usr, _off^_usr, _off^_usr, _off^_usr, _off^_usr, _off^_usr, Ha, Ms, Ha, Ha, Aa^Fpa, Rb, Rb, Aa, Re, Gd, Aa, Gll, Gd, _off^_usr, Gd, Gll, Aa, Gd, Re, Aa, Rb, Rb, Aa^Fpa, Ha, Ha, Ms, Ha, _off^_usr, _off^_usr, _off^_usr, _off^_usr, _off^_usr, _off^_usr, _off^_usr, _off^_usr, _off^_usr, _off^_usr, _off^_usr, _off^_usr, _off^_usr, _off^_usr
_off^_usr, _off^_usr, _off^_usr, _off^_usr, _off^_usr, _off^_usr, _off^_usr, _off^_usr, _off^_usr, _off^_usr, _off^_usr, _off^_usr, _off^_usr, Ms, Aa^Fma, Ha, Cea, Aa, Kea, Cea, Cea, Re, Re, Gd, Aa^Fpa, Gll, _off^_usr, Gll, Aa^Fpa, Gd, Re, Re, Cea, Cea, Kea, Aa, Cea, Ha, Aa^Fma, Ms, _off^_usr, _off^_usr, _off^_usr, _off^_usr, _off^_usr, _off^_usr, _off^_usr, _off^_usr, _off^_usr, _off^_usr, _off^_usr, _off^_usr, _off^_usr, _off^_usr
_off^_usr, _off^_usr, _off^_usr, _off^_usr, _off^_usr, _off^_usr, _off^_usr, _off^_usr, _off^_usr, _off^_usr, _off^_usr, _off^_usr, _off^_usr, Ms, Ha, Cea, Aa^Fma, Cea, Cea, Cea, Ha, Aa, Aa^Fma, Aa^Fma, Ha, Aa^Fda, _off^_usr, Aa^Fda, Ha, Aa^Fma, Aa^Fma, Aa, Ha, Cea, Cea, Cea, Aa^Fma, Cea, Ha, Ms, _off^_usr, _off^_usr, _off^_usr, _off^_usr, _off^_usr, _off^_usr, _off^_usr, _off^_usr, _off^_usr, _off^_usr, _off^_usr, _off^_usr, _off^_usr, _off^_usr
_off^_usr, _off^_usr, _off^_usr, _off^_usr, _off^_usr, _off^_usr, _off^_usr, _off^_usr, _off^_usr, _off^_usr, _off^_usr, _off^_usr, _off^_usr, Ha, Aa^Fma, Ha, Ms, Ha, Ha, Ha, Aa^Fma, Ha, Ms, Ha, Ha, Ha, _off^_usr, Ha, Ha, Ha, Ms, Ha, Aa^Fma, Ha, Ha, Ha, Ms, Ha, Aa^Fma, Ha, _off^_usr, _off^_usr, _off^_usr, _off^_usr, _off^_usr, _off^_usr, _off^_usr, _off^_usr, _off^_usr, _off^_usr, _off^_usr, _off^_usr, _off^_usr, _off^_usr
_off^_usr, _off^_usr, _off^_usr, _off^_usr, _off^_usr, _off^_usr, _off^_usr, _off^_usr, _off^_usr, _off^_usr, _off^_usr, _off^_usr, _off^_usr, Ha, Aa^Fma, Aa^Fma, Ha, Ms, Ha, Aa^Fma, Ms, Ha, Ha, Ms, Ms, Ms, _off^_usr, Ms, Ms, Ms, Ha, Ha, Ms, Aa^Fma, Ha, Ms, Ha, Aa^Fma, Aa^Fma, Ha, _off^_usr, _off^_usr, _off^_usr, _off^_usr, _off^_usr, _off^_usr, _off^_usr, _off^_usr, _off^_usr, _off^_usr, _off^_usr, _off^_usr, _off^_usr, _off^_usr
_off^_usr, _off^_usr, _off^_usr, _off^_usr, _off^_usr, _off^_usr, _off^_usr, _off^_usr, _off^_usr, _off^_usr, _off^_usr, _off^_usr, Ha, Ms, Ha, Ha, Ms, Ha, Ms, Ha, Ms, Ha, Ha, Ha, Ms, Ms^Xm, _off^_usr, Ms^Xm, Ms, Ha, Ha, Ha, Ms, Ha, Ms, Ha, Ms, Ha, Ha, Ms, Ha, _off^_usr, _off^_usr, _off^_usr, _off^_usr, _off^_usr, _off^_usr, _off^_usr, _off^_usr, _off^_usr, _off^_usr, _off^_usr, _off^_usr, _off^_usr
_off^_usr, _off^_usr, _off^_usr, _off^_usr, _off^_usr, _off^_usr, _off^_usr, _off^_usr, _off^_usr, _off^_usr, Ha, Ha, Ha, Ms, Ms, Ms, Ha, Ms, Ha, Ha, Ha, Ms, Ms, Ms, Ms, Ms, _off^_usr, Ms, Ms, Ms, Ms, Ms, Ha, Ha, Ha, Ms, Ha, Ms, Ms, Ms, Ha, Ha, Ha, _off^_usr, _off^_usr, _off^_usr, _off^_usr, _off^_usr, _off^_usr, _off^_usr, _off^_usr, _off^_usr, _off^_usr, _off^_usr
Qlf, Qlf, Qlf, Qlf, Qlf, Qlf, Qlf, Qlf, Qlf, Qlf, Qlf, Qlf, Qlf, Qlf, Qlf, Qlf, Qlf, Qlf, Qlf, Qlf, Qlf, Qlf, Qlf, Qlf, Qlf, Qlf, _off^_usr, Qlf, Qlf, Qlf, Qlf, Qlf, Qlf, Qlf, Qlf, Qlf, Qlf, Qlf, Qlf, Qlf, Qlf, Qlf, Qlf, Qlf, Qlf, Qlf, Qlf, Qlf, Qlf, Qlf, Qlf, Qlf, Qlf, Qlf
Qlf, Qlf, Qlf, Qlf, Qlf, Qlf, Qlf, Qlf, Qlf, Qlf, Qlf, Qlf, Qlf, Qlf, Qlf, Qlf, Qlf, Qlf, Qlf, Qlf, Qlf, Qlf, Qlf, Qlf, Qlf, Qlf, _off^_usr, Qlf, Qlf, Qlf, Qlf, Qlf, Qlf, Qlf, Qlf, Qlf, Qlf, Qlf, Qlf, Qlf, Qlf, Qlf, Qlf, Qlf, Qlf, Qlf, Qlf, Qlf, Qlf, Qlf, Qlf, Qlf, Qlf, Qlf
Qlf, Qlf, Qlf, Qlf, Qlf, Qlf, Qlf, Qlf, Qlf, Qlf, Qlf, Qlf, Qlf, Qlf, Qlf, Qlf, Qlf, Qlf, Qlf, Qlf, Qlf, Qlf, Qlf, Qlf, Qlf, Qlf, _off^_usr, Qlf, Qlf, Qlf, Qlf, Qlf, Qlf, Qlf, Qlf, Qlf, Qlf, Qlf, Qlf, Qlf, Qlf, Qlf, Qlf, Qlf, Qlf, Qlf, Qlf, Qlf, Qlf, Qlf, Qlf, Qlf, Qlf, Qlf
