border_size=1
usage=map

_off^_usr, _off^_usr, _off^_usr, _off^_usr, _off^_usr, _off^_usr, _off^_usr, _off^_usr, _off^_usr, _off^_usr, _off^_usr, _off^_usr, _off^_usr, _off^_usr, _off^_usr, _off^_usr, _off^_usr, _off^_usr, _off^_usr, _off^_usr, _off^_usr, _off^_usr, _off^_usr, _off^_usr, _off^_usr, _off^_usr, _off^_usr, _off^_usr, _off^_usr, _off^_usr, _off^_usr, _off^_usr, _off^_usr, _off^_usr, _off^_usr, _off^_usr, _off^_usr, _off^_usr, _off^_usr, _off^_usr, _off^_usr, _off^_usr, _off^_usr, _off^_usr, _off^_usr, _off^_usr, _off^_usr, _off^_usr, _off^_usr, _off^_usr, _off^_usr, _off^_usr, _off^_usr, _off^_usr
_off^_usr, _off^_usr, _off^_usr, _off^_usr, _off^_usr, _off^_usr, _off^_usr, _off^_usr, _off^_usr, _off^_usr, _off^_usr, _off^_usr, _off^_usr, _off^_usr, _off^_usr, _off^_usr, _off^_usr, _off^_usr, _off^_usr, _off^_usr, _off^_usr, _off^_usr, _off^_usr, _off^_usr, _off^_usr, _off^_usr, _off^_usr, _off^_usr, _off^_usr, _off^_usr, _off^_usr, _off^_usr, _off^_usr, _off^_usr, _off^_usr, _off^_usr, _off^_usr, _off^_usr, _off^_usr, _off^_usr, _off^_usr, _off^_usr, _off^_usr, _off^_usr, _off^_usr, _off^_usr, _off^_usr, _off^_usr, _off^_usr, _off^_usr, _off^_usr, _off^_usr, _off^_usr, _off^_usr
_off^_usr, _off^_usr, _off^_usr, _off^_usr, _off^_usr, _off^_usr, _off^_usr, _off^_usr, _off^_usr, _off^_usr, _off^_usr, _off^_usr, _off^_usr, _off^_usr, _off^_usr, _off^_usr, _off^_usr, _off^_usr, _off^_usr, _off^_usr, _off^_usr, _off^_usr, _off^_usr, _off^_usr, _off^_usr, _off^_usr, _off^_usr, _off^_usr, _off^_usr, _off^_usr, _off^_usr, _off^_usr, _off^_usr, _off^_usr, _off^_usr, _off^_usr, _off^_usr, _off^_usr, _off^_usr, _off^_usr, _off^_usr, _off^_usr, _off^_usr, _off^_usr, _off^_usr, _off^_usr, _off^_usr, _off^_usr, _off^_usr, _off^_usr, _off^_usr, _off^_usr, _off^_usr, _off^_usr
_off^_usr, _off^_usr, _off^_usr, _off^_usr, _off^_usr, _off^_usr, _off^_usr, _off^_usr, _off^_usr, _off^_usr, _off^_usr, _off^_usr, _off^_usr, _off^_usr, _off^_usr, _off^_usr, _off^_usr, _off^_usr, _off^_usr, _off^_usr, _off^_usr, _off^_usr, _off^_usr, _off^_usr, _off^_usr, _off^_usr, _off^_usr, _off^_usr, _off^_usr, _off^_usr, _off^_usr, _off^_usr, _off^_usr, _off^_usr, _off^_usr, _off^_usr, _off^_usr, _off^_usr, _off^_usr, _off^_usr, _off^_usr, _off^_usr, _off^_usr, _off^_usr, _off^_usr, _off^_usr, _off^_usr, _off^_usr, _off^_usr, _off^_usr, _off^_usr, _off^_usr, _off^_usr, _off^_usr
_off^_usr, _off^_usr, _off^_usr, _off^_usr, _off^_usr, _off^_usr, _off^_usr, _off^_usr, _off^_usr, _off^_usr, _off^_usr, _off^_usr, _off^_usr, _off^_usr, _off^_usr, _off^_usr, _off^_usr, _off^_usr, _off^_usr, _off^_usr, _off^_usr, _off^_usr, _off^_usr, _off^_usr, _off^_usr, _off^_usr, _off^_usr, _off^_usr, _off^_usr, _off^_usr, _off^_usr, _off^_usr, _off^_usr, _off^_usr, _off^_usr, _off^_usr, _off^_usr, _off^_usr, _off^_usr, _off^_usr, _off^_usr, _off^_usr, _off^_usr, _off^_usr, _off^_usr, _off^_usr, _off^_usr, _off^_usr, _off^_usr, _off^_usr, _off^_usr, _off^_usr, _off^_usr, _off^_usr
_off^_usr, _off^_usr, _off^_usr, _off^_usr, _off^_usr, _off^_usr, _off^_usr, _off^_usr, _off^_usr, _off^_usr, _off^_usr, _off^_usr, _off^_usr, _off^_usr, _off^_usr, _off^_usr, _off^_usr, _off^_usr, _off^_usr, _off^_usr, _off^_usr, _off^_usr, _off^_usr, _off^_usr, _off^_usr, _off^_usr, _off^_usr, _off^_usr, _off^_usr, _off^_usr, _off^_usr, _off^_usr, _off^_usr, _off^_usr, _off^_usr, _off^_usr, _off^_usr, _off^_usr, _off^_usr, _off^_usr, _off^_usr, _off^_usr, _off^_usr, _off^_usr, _off^_usr, _off^_usr, _off^_usr, _off^_usr, _off^_usr, _off^_usr, _off^_usr, _off^_usr, _off^_usr, _off^_usr
_off^_usr, _off^_usr, _off^_usr, _off^_usr, _off^_usr, _off^_usr, _off^_usr, _off^_usr, _off^_usr, _off^_usr, _off^_usr, _off^_usr, _off^_usr, _off^_usr, _off^_usr, _off^_usr, _off^_usr, _off^_usr, _off^_usr, _off^_usr, _off^_usr, _off^_usr, _off^_usr, _off^_usr, Ms, Ms, Ha, Ms, Ms, _off^_usr, _off^_usr, _off^_usr, _off^_usr, _off^_usr, _off^_usr, _off^_usr, _off^_usr, _off^_usr, _off^_usr, _off^_usr, _off^_usr, _off^_usr, _off^_usr, _off^_usr, _off^_usr, _off^_usr, _off^_usr, _off^_usr, _off^_usr, _off^_usr, _off^_usr, _off^_usr, _off^_usr, _off^_usr
_off^_usr, _off^_usr, _off^_usr, _off^_usr, _off^_usr, _off^_usr, _off^_usr, _off^_usr, _off^_usr, _off^_usr, _off^_usr, _off^_usr, _off^_usr, _off^_usr, _off^_usr, _off^_usr, _off^_usr, _off^_usr, _off^_usr, _off^_usr, Ms, _off^_usr, Aa^Fpa, Aa^Fpa, Ha^Vhha, Ha, Ms, Ha, Ha^Vhha, Aa^Fpa, Aa^Fpa, _off^_usr, Ms, _off^_usr, _off^_usr, _off^_usr, _off^_usr, _off^_usr, _off^_usr, _off^_usr, _off^_usr, _off^_usr, _off^_usr, _off^_usr, _off^_usr, _off^_usr, _off^_usr, _off^_usr, _off^_usr, _off^_usr, _off^_usr, _off^_usr, _off^_usr, _off^_usr
_off^_usr, _off^_usr, _off^_usr, _off^_usr, _off^_usr, _off^_usr, _off^_usr, _off^_usr, Ha, _off^_usr, _off^_usr, _off^_usr, _off^_usr, _off^_usr, Aa^Fpa, _off^_usr, Aa^Fpa, _off^_usr, Aa^Fpa, Ms, Ms, Ms, Ha, Aa^Fpa, Aa^Fpa, Ha, Ha, Ha, Aa^Fpa, Aa^Fpa, Ha, Ms, Ms, Ms, Aa^Fpa, _off^_usr, Aa^Fpa, _off^_usr, Aa^Fpa, _off^_usr, _off^_usr, _off^_usr, _off^_usr, _off^_usr, Ha, _off^_usr, _off^_usr, _off^_usr, _off^_usr, _off^_usr, _off^_usr, _off^_usr, _off^_usr, _off^_usr
_off^_usr, _off^_usr, _off^_usr, _off^_usr, _off^_usr, _off^_usr, Aa^Fpa, Ha, Ms, Ha, Ha, Ha, Aa, Aa^Fpa, Aa^Fpa, Aa^Fpa, Aa^Fpa, Aa^Fpa, Aa^Fpa, Ms, Ha, Ha, Wwf, Ha, Wwf, Cha, Cha, Cha, Wwf, Ha, Wwf, Ha, Ha, Ms, Aa^Fpa, Aa^Fpa, Aa^Fpa, Aa^Fpa, Aa^Fpa, Aa^Fpa, Aa, Ha, Ha, Ha, Ms, Ha, Aa^Fpa, _off^_usr, _off^_usr, _off^_usr, _off^_usr, _off^_usr, _off^_usr, _off^_usr
_off^_usr, _off^_usr, _off^_usr, _off^_usr, _off^_usr, _off^_usr, Aa^Fpa, Ha, Ms, Ms, Ms, Ha, Aa^Fpa, Aa, Aa, Aa^Fpa, Aa, Aa^Fpa, Aa^Vla, Ha, Aa^Fpa, Ha, Rr, Wwf, Wwf^Bw/, Cha, Kha, Cha, Wwf^Bw\, Wwf, Rr, Ha, Aa^Fpa, Ha, Aa^Vla, Aa^Fpa, Aa, Aa^Fpa, Aa, Aa, Aa^Fpa, Ha, Ms, Ms, Ms, Ha, Aa^Fpa, _off^_usr, _off^_usr, _off^_usr, _off^_usr, _off^_usr, _off^_usr, _off^_usr
_off^_usr, _off^_usr, _off^_usr, _off^_usr, _off^_usr, _off^_usr, Aa^Fpa, Aa, Aa^Fpa, Ms, Ms, Ms, Aa^Fpa, Aa^Fpa, Cha, Aa, Rr, Aa^Fpa, Rr, Rr, Rr, Rr, Rr, Rr, Wwf, Wwf, Cha, Wwf, Wwf, Rr, Rr, Rr, Rr, Rr, Rr, Aa^Fpa, Rr, Aa, Cha, Aa^Fpa, Aa^Fpa, Ms, Ms, Ms, Aa^Fpa, Aa, Aa^Fpa, _off^_usr, _off^_usr, _off^_usr, _off^_usr, _off^_usr, _off^_usr, _off^_usr
_off^_usr, _off^_usr, _off^_usr, _off^_usr, _off^_usr, _off^_usr, Cha, Cha, Cha, Aa^Fpa, Cha, Cha, Cha, Cha, Cha, Aa^Fpa, Rr, Rr, Rr, Rr, Rr, Rr, Ai, Cea, Wwf, Ds, Ds, Ds, Wwf, Cea, Ai, Rr, Rr, Rr, Rr, Rr, Rr, Aa^Fpa, Cha, Cha, Cha, Cha, Cha, Aa^Fpa, Cha, Cha, Cha, _off^_usr, _off^_usr, _off^_usr, _off^_usr, _off^_usr, _off^_usr, _off^_usr
_off^_usr, _off^_usr, _off^_usr, _off^_usr, _off^_usr, _off^_usr, Cha, Rrc^Vhca, Aa, Cha, Rrc^Vhca, Aa^Fpa, Rrc, Rrc^Vhca, Aa, Cha, Cha, Rr, Aa^Fpa, Aa^Fpa, Aa^Fpa, Aa^Vca, Ai, Wwf, Ds, Ds, Ds, Ds, Ds, Wwf, Ai, Aa^Vca, Aa^Fpa, Aa^Fpa, Aa^Fpa, Rr, Cha, Cha, Aa, Rrc^Vhca, Rrc, Aa^Fpa, Rrc^Vhca, Cha, Aa, Rrc^Vhca, Cha, _off^_usr, _off^_usr, _off^_usr, _off^_usr, _off^_usr, _off^_usr, _off^_usr
_off^_usr, _off^_usr, _off^_usr, _off^_usr, _off^_usr, _off^_usr, Cha, Aa, Rrc^Vhca, Aa, Rrc, Aa, Rrc, Rrc, Rrc^Vhca, Rrc^Vhca, Cha, Aa^Fpa, Wwf, Wwf, Ai, Ai, Wwrg, Wwf, Wwf, Ds, Cea, Ds, Wwf, Wwf, Wwrg, Ai, Ai, Wwf, Wwf, Aa^Fpa, Cha, Rrc^Vhca, Rrc^Vhca, Rrc, Rrc, Aa, Rrc, Aa, Rrc^Vhca, Aa, Cha, _off^_usr, _off^_usr, _off^_usr, _off^_usr, _off^_usr, _off^_usr, _off^_usr
_off^_usr, _off^_usr, _off^_usr, _off^_usr, _off^_usr, _off^_usr, Cha, Rrc, Aa, Rrc, Rrc^Vhca, Rrc, Kha, Aa, Cha, Cha, Aa^Fpa, Aa^Fpa, Ai, Wwf, Wwg, Wwf, Wwf, Wwf, Wwrg, Wwrg, Wwf, Wwrg, Wwrg, Wwf, Wwf, Wwf, Wwg, Wwf, Ai, Aa^Fpa, Aa^Fpa, Cha, Cha, Aa, Kha, Rrc, Rrc^Vhca, Rrc, Aa, Rrc, Cha, _off^_usr, _off^_usr, _off^_usr, _off^_usr, _off^_usr, _off^_usr, _off^_usr
_off^_usr, _off^_usr, _off^_usr, _off^_usr, _off^_usr, _off^_usr, Cha, Rrc, Cha, Rrc, Cha, Cha, Cha, Cha, Rr, Rr, Rr, Aa^Fpa, Ai, Wwf, Wwg, Wwg, Gs^Fms, Gs^Fms, Hh, Wwf, _off^_usr, Wwf, Hh, Gs^Fms, Gs^Fms, Wwg, Wwg, Wwf, Ai, Aa^Fpa, Rr, Rr, Rr, Cha, Cha, Cha, Cha, Rrc, Cha, Rrc, Cha, _off^_usr, _off^_usr, _off^_usr, _off^_usr, _off^_usr, _off^_usr, _off^_usr
_off^_usr, _off^_usr, _off^_usr, _off^_usr, _off^_usr, _off^_usr, Aa^Fpa, Cha, Aa, Cha, Aa^Fpa, Aa^Fpa, Aa^Fpa, Aa^Fpa, Rr, Rr, Rr, Aa^Fpa, Ai, Wwf, Wwg, Gs^Fms, Gs^Fms, Hh, Mm, Hh, _off^_usr, Hh, Mm, Hh, Gs^Fms, Gs^Fms, Wwg, Wwf, Ai, Aa^Fpa, Rr, Rr, Rr, Aa^Fpa, Aa^Fpa, Aa^Fpa, Aa^Fpa, Cha, Aa, Cha, Aa^Fpa, _off^_usr, _off^_usr, _off^_usr, _off^_usr, _off^_usr, _off^_usr, _off^_usr
_off^_usr, _off^_usr, _off^_usr, _off^_usr, _off^_usr, _off^_usr, Ha, Aa^Fpa, Aa^Fma, Aa^Fpa, Aa^Fpa, Aa^Fpa, Aa^Fpa, Aa^Fpa, Aa^Fpa, Rr, Rr, Aa^Fpa, Wwf, Ai, Wwrg, Wwf, Gs^Fms, Hh, Gs^Fds, Mm, _off^_usr, Mm, Gs^Fds, Hh, Gs^Fms, Wwf, Wwrg, Ai, Wwf, Aa^Fpa, Rr, Rr, Aa^Fpa, Aa^Fpa, Aa^Fpa, Aa^Fpa, Aa^Fpa, Aa^Fpa, Aa^Fpa, Aa^Fpa, Ha, _off^_usr, _off^_usr, _off^_usr, _off^_usr, _off^_usr, _off^_usr, _off^_usr
_off^_usr, _off^_usr, _off^_usr, _off^_usr, _off^_usr, _off^_usr, Aa^Fpa, Ha, Aa^Fma, Aa^Fma, Ms, Ha, Ha, Aa^Vea, Ai, Ai, Wwg, Wwg^Bsb\, Wwg^Bsb\, Wwg, Wwg, Wwg, Wwf, Wwf, Gs^Fds, Mm, _off^_usr, Mm, Gs^Fds, Wwf, Wwf, Wwg, Wwg, Wwg, Wwg^Bsb/, Wwg^Bsb/, Wwg, Ai, Ai, Aa^Vea, Ha, Ha, Ms, Aa^Fpa, Aa^Fpa, Ha, Aa^Fpa, _off^_usr, _off^_usr, _off^_usr, _off^_usr, _off^_usr, _off^_usr, _off^_usr
_off^_usr, _off^_usr, _off^_usr, _off^_usr, _off^_usr, _off^_usr, Mm, Ms, Aa, Ms, Mm, Mm, Aa, Wwf, Ai, Wwf, Wwg, Wwg, Wwg, Wwg^Bsb\, Gg, Gg, Gg, Gg, Gg, Hh, _off^_usr, Hh, Gg, Gg, Gg, Gg, Gg, Wwg^Bsb/, Wwg, Wwg, Wwg, Wwf, Ai, Wwf, Aa, Mm, Mm, Ms, Aa, Ms, Mm, _off^_usr, _off^_usr, _off^_usr, _off^_usr, _off^_usr, _off^_usr, _off^_usr
_off^_usr, _off^_usr, _off^_usr, _off^_usr, _off^_usr, _off^_usr, Mm, Mm, Mm, Mm, Hh, Hh, Wwf, Ai, Wwf, Wwf, Wwf, Wwg, Wwf, Chr, Gg, Gg, Gs^Fds, Gg, Gs^Fds, Gg, _off^_usr, Gg, Gs^Fds, Gg, Gs^Fds, Gg, Gg, Chr, Wwf, Wwg, Wwf, Wwf, Wwf, Ai, Wwf, Hh, Hh, Mm, Mm, Mm, Mm, _off^_usr, _off^_usr, _off^_usr, _off^_usr, _off^_usr, _off^_usr, _off^_usr
_off^_usr, _off^_usr, _off^_usr, _off^_usr, _off^_usr, _off^_usr, Hh, Mm, Hh, Mm, Hh, Wwf, Wwg, Wwf, Wwf, Wwf, Gs^Fds, Wwf, Hh, Gs^Fds, Gs^Fds, Gs^Fds, Gg, Gg, Gs^Fds, Gg, _off^_usr, Gg, Gs^Fds, Gg, Gg, Gs^Fds, Gs^Fds, Gs^Fds, Hh, Wwf, Gs^Fds, Wwf, Wwf, Wwf, Wwg, Wwf, Hh, Mm, Hh, Mm, Hh, _off^_usr, _off^_usr, _off^_usr, _off^_usr, _off^_usr, _off^_usr, _off^_usr
_off^_usr, _off^_usr, _off^_usr, _off^_usr, _off^_usr, _off^_usr, Ss, Hh, Gs^Ft, Hh, Wwrg, Wwrg, Wwg, Wwg, Ss, Gs^Fds, Hh, Hh, Mm, Gs^Fds, Gs^Fds, Gs^Fds, Gg, Gs^Fds, Gg^Ve, Gg, _off^_usr, Gg, Gg^Ve, Gs^Fds, Gg, Gs^Fds, Gs^Fds, Gs^Fds, Mm, Hh, Hh, Gs^Fds, Ss, Wwg, Wwg, Wwrg, Wwrg, Hh, Gs^Ft, Hh, Ss, _off^_usr, _off^_usr, _off^_usr, _off^_usr, _off^_usr, _off^_usr, _off^_usr
_off^_usr, _off^_usr, _off^_usr, _off^_usr, _off^_usr, _off^_usr, Ss, Gs^Ft, Gs^Ft, Ss, Wwrg, Wwg, Wwg, Wwrg, Ss, Gs^Fds, Gs^Fds, Hh, Mm, Mm, Mm, Gs^Fds, Gs^Fds, Gg, Gg, Gg, _off^_usr, Gg, Gg, Gg, Gs^Fds, Gs^Fds, Mm, Mm, Mm, Hh, Gs^Fds, Gs^Fds, Ss, Wwrg, Wwg, Wwg, Wwrg, Ss, Gs^Ft, Gs^Ft, Ss, _off^_usr, _off^_usr, _off^_usr, _off^_usr, _off^_usr, _off^_usr, _off^_usr
_off^_usr, _off^_usr, _off^_usr, _off^_usr, _off^_usr, _off^_usr, Ss, Ss, Chs, Ss, Wwf, Wwg, Wwg, Ss, Wwrg, Ss, Wwrg, Gs^Fds, Hh, Mm, Gs^Fds, Gs^Fds, Gs^Fds, Gs^Fms, Gg, Gs^Fms, _off^_usr, Gs^Fms, Gg, Gs^Fms, Gs^Fds, Gs^Fds, Gs^Fds, Mm, Hh, Gs^Fds, Wwrg, Ss, Wwrg, Ss, Wwg, Wwg, Wwf, Ss, Chs, Ss, Ss, _off^_usr, _off^_usr, _off^_usr, _off^_usr, _off^_usr, _off^_usr, _off^_usr
_off^_usr, _off^_usr, _off^_usr, _off^_usr, _off^_usr, _off^_usr, Khs, Chs, Ss^Vhs, Wwf, Wwf, Wwg, Wwg, Wwg, Wwg, Wwg, Ss, Ss^Vhs, Ss, Hh, Gs^Fds, Gs^Fds, Gs^Fds, Gg, Gs^Fms, Hh, _off^_usr, Hh, Gs^Fms, Gg, Gs^Fds, Gs^Fds, Gs^Fds, Hh, Ss, Ss^Vhs, Ss, Wwg, Wwg, Wwg, Wwg, Wwg, Wwf, Wwf, Ss^Vhs, Chs, Khs, _off^_usr, _off^_usr, _off^_usr, _off^_usr, _off^_usr, _off^_usr, _off^_usr
_off^_usr, _off^_usr, _off^_usr, _off^_usr, _off^_usr, _off^_usr, Gs^Ft, Chs, Ss, Wwf, Wwf, Ss, Wwrg, Ss, Ss, Ss, Gs^Ft, Ss, Ss, Ss, Gs^Fds, Gs^Fds, Gs^Fms, Gg, Hh, Hh, _off^_usr, Hh, Hh, Gg, Gs^Fms, Gs^Fds, Gs^Fds, Ss, Ss, Ss, Gs^Ft, Ss, Ss, Ss, Wwrg, Ss, Wwf, Wwf, Ss, Chs, Gs^Ft, _off^_usr, _off^_usr, _off^_usr, _off^_usr, _off^_usr, _off^_usr, _off^_usr
_off^_usr, _off^_usr, _off^_usr, _off^_usr, _off^_usr, _off^_usr, Gs^Ft, Gs^Ft, Ss, Ss, Wwf, Ss, Wwf, Wwrg, Ss, Gs^Ft, Gs^Ft, Ss, Gg, Gg, Gg, Gg, Gg, Gg, Gs^Fms, Gs^Fms, _off^_usr, Gs^Fms, Gs^Fms, Gg, Gg, Gg, Gg, Gg, Gg, Ss, Gs^Ft, Gs^Ft, Ss, Wwrg, Wwf, Ss, Wwf, Ss, Ss, Gs^Ft, Gs^Ft, _off^_usr, _off^_usr, _off^_usr, _off^_usr, _off^_usr, _off^_usr, _off^_usr
_off^_usr, _off^_usr, _off^_usr, _off^_usr, _off^_usr, _off^_usr, Ss, Ss, Gs^Ft, Gs^Ft, Ss, Wwf, Ss, Wwf, Wwf, Ss, Ss, Ss, Gs^Fms, Gg, Gs^Fms, Gs^Fms, Hh, Gs^Fms, Gs^Fms, Gs^Fms, _off^_usr, Gs^Fms, Gs^Fms, Gs^Fms, Hh, Gs^Fms, Gs^Fms, Gg, Gs^Fms, Ss, Ss, Ss, Wwf, Wwf, Ss, Wwf, Ss, Gs^Ft, Gs^Ft, Ss, Ss, _off^_usr, _off^_usr, _off^_usr, _off^_usr, _off^_usr, _off^_usr, _off^_usr
_off^_usr, _off^_usr, _off^_usr, _off^_usr, _off^_usr, _off^_usr, Hh, Ss, Ss, Ss, Gs^Ft, Ss, Gs^Ft, Ss, Ss, Wwf, Gg, Gs^Fms, Gg, Gg, Hh, Gs^Fms, Hh, Mm, Mm, Mm, _off^_usr, Mm, Mm, Mm, Hh, Gs^Fms, Hh, Gg, Gg, Gs^Fms, Gg, Wwf, Ss, Ss, Gs^Ft, Ss, Gs^Ft, Ss, Ss, Ss, Hh, _off^_usr, _off^_usr, _off^_usr, _off^_usr, _off^_usr, _off^_usr, _off^_usr
_off^_usr, _off^_usr, _off^_usr, _off^_usr, _off^_usr, _off^_usr, Gs^Fds, Hh, Ss, Ss, Ss, Gs^Ft, Gs^Ft, Ss, Ss, Wwf, Wwf, Gg, Gg, Gs^Fms, Hh, Mm, Mm, Hh, Mm, Mm, _off^_usr, Mm, Mm, Hh, Mm, Mm, Hh, Gs^Fms, Gg, Gg, Wwf, Wwf, Ss, Ss, Gs^Ft, Gs^Ft, Ss, Ss, Ss, Hh, Gs^Fds, _off^_usr, _off^_usr, _off^_usr, _off^_usr, _off^_usr, _off^_usr, _off^_usr
_off^_usr, _off^_usr, _off^_usr, _off^_usr, _off^_usr, _off^_usr, Gs^Fds, Gs^Fds, Gs^Fds, Gs^Fds, Ss, Ss, Ss, Ss, Gs^Fds, Ss, Wwf, Gg, Gg, Hh, Wwg, Gs^Fms, Wwg, Hh, Hh, Hh, _off^_usr, Hh, Hh, Hh, Wwg, Gs^Fms, Wwg, Hh, Gg, Gg, Wwf, Ss, Gs^Fds, Ss, Ss, Ss, Ss, Gs^Fds, Gs^Fds, Gs^Fds, Gs^Fds, _off^_usr, _off^_usr, _off^_usr, _off^_usr, _off^_usr, _off^_usr, _off^_usr
_off^_usr, _off^_usr, _off^_usr, _off^_usr, _off^_usr, _off^_usr, Gg^Ve, Gg, Gg, Gg, Gg, Ss, Gs^Fds, Ss, Gg, Gg, Gs^Fds, Wwf, Wwf, Wwg, Gg, Wwg, Gs^Fds, Wwg, Wwg, Gg, _off^_usr, Gg, Wwg, Wwg, Gs^Fds, Wwg, Gg, Wwg, Wwf, Wwf, Gs^Fds, Gg, Gg, Ss, Gs^Fds, Ss, Gg, Gg, Gg, Gg, Gg^Ve, _off^_usr, _off^_usr, _off^_usr, _off^_usr, _off^_usr, _off^_usr, _off^_usr
_off^_usr, _off^_usr, _off^_usr, _off^_usr, _off^_usr, _off^_usr, Gs^Fms, Gs^Fms, Hh, Hh, Gg, Gg, Gg, Gg, Gg^Ve, Gs^Fds, Mm, Hh, Hh, Gg, Gg, Gs^Fds, Gs^Fds, Gs^Fds, Wwg, Gg, _off^_usr, Gg, Wwg, Gs^Fds, Gs^Fds, Gs^Fds, Gg, Gg, Hh, Hh, Mm, Gs^Fds, Gg^Ve, Gg, Gg, Gg, Gg, Hh, Hh, Gs^Fms, Gs^Fms, _off^_usr, _off^_usr, _off^_usr, _off^_usr, _off^_usr, _off^_usr, _off^_usr
_off^_usr, _off^_usr, _off^_usr, _off^_usr, _off^_usr, _off^_usr, Gs^Fms, Gs^Fms, Hh, Gs^Fms, Gg, Gg, Gs^Fds, Gs^Fds, Hh, Hh, Mm, Hh, Mm, Hh, Gg^Ve, Gg, Wwf, Wwf, Gg, Gg, _off^_usr, Gg, Gg, Wwf, Wwf, Gg, Gg^Ve, Hh, Mm, Hh, Mm, Hh, Hh, Gs^Fds, Gs^Fds, Gg, Gg, Gs^Fms, Hh, Gs^Fms, Gs^Fms, _off^_usr, _off^_usr, _off^_usr, _off^_usr, _off^_usr, _off^_usr, _off^_usr
_off^_usr, _off^_usr, _off^_usr, _off^_usr, _off^_usr, _off^_usr, Gg, Hh, Gs^Fms, Gs^Fms, Wwg, Wwg, Wwg, Hh, Gs^Fms, Hh, Gs^Fms, Gs^Fms, Hh, Hh, Gs^Fds, Gs^Fds, Wwg, Gg, Gs^Fds, Gs^Fms, _off^_usr, Gs^Fms, Gs^Fds, Gg, Wwg, Gs^Fds, Gs^Fds, Hh, Hh, Gs^Fms, Gs^Fms, Hh, Gs^Fms, Hh, Wwg, Wwg, Wwg, Gs^Fms, Gs^Fms, Hh, Gg, _off^_usr, _off^_usr, _off^_usr, _off^_usr, _off^_usr, _off^_usr, _off^_usr
_off^_usr, _off^_usr, _off^_usr, _off^_usr, _off^_usr, _off^_usr, Gg, Gg, Wwg, Wwg, Gs^Fds, Wwg, Wwg, Gs^Fds, Wwg, Gs^Fms, Wwf, Hh, Wwf, Wwf, Wwf, Gs^Fds, Wwg, Gg, Gs^Fds, Gs^Fms, _off^_usr, Gs^Fms, Gs^Fds, Gg, Wwg, Gs^Fds, Wwf, Wwf, Wwf, Hh, Wwf, Gs^Fms, Wwg, Gs^Fds, Wwg, Wwg, Gs^Fds, Wwg, Wwg, Gg, Gg, _off^_usr, _off^_usr, _off^_usr, _off^_usr, _off^_usr, _off^_usr, _off^_usr
_off^_usr, _off^_usr, _off^_usr, _off^_usr, _off^_usr, _off^_usr, Gg, Wwg, Wwg, Gs^Fds, Wwg, Wwg, Wwg, Wwg, Hh, Wwg, Hh, Wwf, Wwf, Gs^Fms, Gs^Fms, Wwg, Gg, Gg, Gs^Fds, Hh, _off^_usr, Hh, Gs^Fds, Gg, Gg, Wwg, Gs^Fms, Gs^Fms, Wwf, Wwf, Hh, Wwg, Hh, Wwg, Wwg, Wwg, Wwg, Gs^Fds, Wwg, Wwg, Gg, _off^_usr, _off^_usr, _off^_usr, _off^_usr, _off^_usr, _off^_usr, _off^_usr
_off^_usr, _off^_usr, _off^_usr, _off^_usr, _off^_usr, _off^_usr, Gg, Gg, Gg, Wwg, Wwg, Wwg, Wwg, Wwg, Hh, Hh, Hh, Gs^Fms, Wwg, Hh, Gg, Gg, Gg, Gg, Gg, Hh, _off^_usr, Hh, Gg, Gg, Gg, Gg, Gg, Hh, Wwg, Gs^Fms, Hh, Hh, Hh, Wwg, Wwg, Wwg, Wwg, Wwg, Gg, Gg, Gg, _off^_usr, _off^_usr, _off^_usr, _off^_usr, _off^_usr, _off^_usr, _off^_usr
_off^_usr, _off^_usr, _off^_usr, _off^_usr, _off^_usr, _off^_usr, Gd, Gs^Fds, Gg, Wwg, Wwg, Wwg, Wwg, Hh, Hh^Vhh, Mm, Gg^Fet, Wwg, Wwg, Wwg, Gg, Hh, Hh, Gs^Fds, Gs^Fds, Gg, _off^_usr, Gg, Gs^Fds, Gs^Fds, Hh, Hh, Gg, Wwg, Wwg, Wwg, Gg^Fet, Mm, Hh^Vhh, Hh, Wwg, Wwg, Wwg, Wwg, Gg, Gs^Fds, Gd, _off^_usr, _off^_usr, _off^_usr, _off^_usr, _off^_usr, _off^_usr, _off^_usr
_off^_usr, _off^_usr, _off^_usr, _off^_usr, _off^_usr, _off^_usr, Gd, Gs^Fds, Gs^Fds, Gg, Gg, Gg, Gg, Gg, Gs^Fms, Gs^Fds, Hh, Wwg, Gs^Fms, Gg, Gg, Hh, Mm, Hh, Hh, Gg, _off^_usr, Gg, Hh, Hh, Mm, Hh, Gg, Gg, Gs^Fms, Wwg, Hh, Gs^Fds, Gs^Fms, Gg, Gg, Gg, Gg, Gg, Gs^Fds, Gs^Fds, Gd, _off^_usr, _off^_usr, _off^_usr, _off^_usr, _off^_usr, _off^_usr, _off^_usr
_off^_usr, _off^_usr, _off^_usr, _off^_usr, _off^_usr, _off^_usr, Rd, Gd, Gd, Gg, Gs^Fms, Gg, Gg, Gs^Fms, Gs^Fms, Hh, Gs^Fms, Gs^Fms, Cv, Cv, Cv, Gs^Fds, Gs^Fds, Mm, Hh, Gs^Fds, _off^_usr, Gs^Fds, Hh, Mm, Gs^Fds, Gs^Fds, Cv, Cv, Cv, Gs^Fms, Gs^Fms, Hh, Gs^Fms, Gs^Fms, Gg, Gg, Gs^Fms, Gg, Gd, Gd, Rd, _off^_usr, _off^_usr, _off^_usr, _off^_usr, _off^_usr, _off^_usr, _off^_usr
_off^_usr, _off^_usr, _off^_usr, _off^_usr, _off^_usr, _off^_usr, Qlf, Rd, Rd, Gd, Gd, Gg, Gs^Fms, Gg, Gg, Hh, Hh, Gs^Fms, Gg, Kv, Cv, Cv, Hh, Hh, Gs^Fds, Gs^Fds, _off^_usr, Gs^Fds, Gs^Fds, Hh, Hh, Cv, Cv, Kv, Gg, Gs^Fms, Hh, Hh, Gg, Gg, Gs^Fms, Gg, Gd, Gd, Rd, Rd, Qlf, _off^_usr, _off^_usr, _off^_usr, _off^_usr, _off^_usr, _off^_usr, _off^_usr
_off^_usr, _off^_usr, _off^_usr, _off^_usr, _off^_usr, _off^_usr, Qlf, Mv, Rd, Rd, Gd^Fetd, Gd, Gd, Gg, Gs^Fms, Gg, Gg, Gg, Gg, Gg, Gg, Gg, Gg, Gs^Vl, Gg, Gg, _off^_usr, Gg, Gg, Gs^Vl, Gg, Gg, Gg, Gg, Gg, Gg, Gg, Gg, Gs^Fms, Gg, Gd, Gd, Gd^Fetd, Rd, Rd, Mv, Qlf, _off^_usr, _off^_usr, _off^_usr, _off^_usr, _off^_usr, _off^_usr, _off^_usr
_off^_usr, _off^_usr, _off^_usr, _off^_usr, _off^_usr, _off^_usr, Qlf, Qlf, Mv, Rd, Rd, Gd, Gd, Gs^Fds, Gs^Fms, Gs^Fms, Gg, Gg, Gs^Fds, Gs^Fms, Gg, Gg, Gg, Gg, Gs^Fms, Gg, _off^_usr, Gg, Gs^Fms, Gg, Gg, Gg, Gg, Gs^Fms, Gs^Fds, Gg, Gg, Gs^Fms, Gs^Fms, Gs^Fds, Gd, Gd, Rd, Rd, Mv, Qlf, Qlf, _off^_usr, _off^_usr, _off^_usr, _off^_usr, _off^_usr, _off^_usr, _off^_usr
_off^_usr, _off^_usr, _off^_usr, _off^_usr, _off^_usr, _off^_usr, Qlf, Qlf, Qlf, Rd, Mv, Rd, Gd^Fetd, Gd, Gd, Gs, Gd, Gd, Gd, Gs^Fds, Gd, Gg, Gg, Gs^Fms, Gs, Gs^Fms, _off^_usr, Gs^Fms, Gs, Gs^Fms, Gg, Gg, Gd, Gs^Fds, Gd, Gd, Gd, Gs, Gd, Gd, Gd^Fetd, Rd, Mv, Rd, Qlf, Qlf, Qlf, _off^_usr, _off^_usr, _off^_usr, _off^_usr, _off^_usr, _off^_usr, _off^_usr
_off^_usr, _off^_usr, _off^_usr, _off^_usr, _off^_usr, _off^_usr, Qlf, Qlf, Qlf, Qlf, Qlf, Rd, Rd, Rd, Rd, Gd, Gs, Gs, Gs, Gs, Gd, Gd, Gd, Gd, Rd, Re, _off^_usr, Re, Rd, Gd, Gd, Gd, Gd, Gs, Gs, Gs, Gs, Gd, Rd, Rd, Rd, Rd, Qlf, Qlf, Qlf, Qlf, Qlf, _off^_usr, _off^_usr, _off^_usr, _off^_usr, _off^_usr, _off^_usr, _off^_usr
Qlf, Qlf, Qlf, Qlf, Qlf, Qlf, Qlf, Qlf, Qlf, Qlf, Qlf, Qlf, Qlf, Qlf, Qlf, Qlf, Qlf, Qlf, Qlf, Qlf, Qlf, Qlf, Qlf, Qlf, Qlf, Qlf, _off^_usr, Qlf, Qlf, Qlf, Qlf, Qlf, Qlf, Qlf, Qlf, Qlf, Qlf, Qlf, Qlf, Qlf, Qlf, Qlf, Qlf, Qlf, Qlf, Qlf, Qlf, Qlf, Qlf, Qlf, Qlf, Qlf, Qlf, Qlf
Qlf, Qlf, Qlf, Qlf, Qlf, Qlf, Qlf, Qlf, Qlf, Qlf, Qlf, Qlf, Qlf, Qlf, Qlf, Qlf, Qlf, Qlf, Qlf, Qlf, Qlf, Qlf, Qlf, Qlf, Qlf, Qlf, _off^_usr, Qlf, Qlf, Qlf, Qlf, Qlf, Qlf, Qlf, Qlf, Qlf, Qlf, Qlf, Qlf, Qlf, Qlf, Qlf, Qlf, Qlf, Qlf, Qlf, Qlf, Qlf, Qlf, Qlf, Qlf, Qlf, Qlf, Qlf
Qlf, Qlf, Qlf, Qlf, Qlf, Qlf, Qlf, Qlf, Qlf, Qlf, Qlf, Qlf, Qlf, Qlf, Qlf, Qlf, Qlf, Qlf, Qlf, Qlf, Qlf, Qlf, Qlf, Qlf, Qlf, Qlf, _off^_usr, Qlf, Qlf, Qlf, Qlf, Qlf, Qlf, Qlf, Qlf, Qlf, Qlf, Qlf, Qlf, Qlf, Qlf, Qlf, Qlf, Qlf, Qlf, Qlf, Qlf, Qlf, Qlf, Qlf, Qlf, Qlf, Qlf, Qlf
