border_size=1
usage=map

Xv, Xv, Xv, Xv, Xv, Xv, Xv, Xv, Xv, Xv, Xv, Xv, Xv, Xv, Xv, Xv, Xv, Xv, Xv, Xv, Xv, Xv, Xv, Xv, Xv, Xv, Xv, Xv, Xv, Xv, Xv, Xv, Xv, Xv, Xv, Xv, Xv, Xv, Xv, Xv, Xv, Xv, Xv, Xv, Xv, Xv, Xv, Xv, Xv, Xv, Xv, Xv, Xv, Xv
Xv, Xv, Xv, Xv, Xv, Xv, Xv, Xv, Xv, Xv, Xv, Xv, Xv, Xv, Xv, Xv, Xv, Xv, Xv, Xv, Xv, Xv, Xv, Xv, Xv, Xv, Xv, Xv, Xv, Xv, Xv, Xv, Xv, Xv, Xv, Xv, Xv, Xv, Xv, Xv, Xv, Xv, Xv, Xv, Xv, Xv, Xv, Xv, Xv, Xv, Xv, Xv, Xv, Xv
Xv, Xv, Xv, Xv, Xv, Xv, Xv, Xv, Xv, Xv, Xv, Xv, Xv, Xv, Xv, Xv, Xv, Xv, Xv, Xv, Xv, Xv, Xv, Xv, Xv, Xv, Xv, Xv, Xv, Xv, Xv, Xv, Xv, Xv, Xv, Xv, Xv, Xv, Xv, Xv, Xv, Xv, Xv, Xv, Xv, Xv, Xv, Xv, Xv, Xv, Xv, Xv, Xv, Xv
Xv, Xv, Xv, Xv, Xv, Xv, Xv, Xv, Xv, Xv, Xv, Xv, Xv, Xv, Xv, Xv, Xv, Xv, Xv, Xv, Xv, Xv, Xv, Xv, Xv, Xv, Xv, Xv, Xv, Xv, Xv, Xv, Xv, Xv, Xv, Xv, Xv, Xv, Xv, Xv, Xv, Xv, Xv, Xv, Xv, Xv, Xv, Xv, Xv, Xv, Xv, Xv, Xv, Xv
_off^_usr, _off^_usr, _off^_usr, _off^_usr, _off^_usr, _off^_usr, Gg^Ve, Gg, Gg, Gg, Gg, Ss, Gs^Fds, Ss, Gg, Gg, Gs^Fds, Wwf, Wwf, Wwg, Gg, Wwg, Gs^Fds, Wwg, Wwg, Gg, _off^_usr, Gg, Wwg, Wwg, Gs^Fds, Wwg, Gg, Wwg, Wwf, Wwf, Gs^Fds, Gg, Gg, Ss, Gs^Fds, Ss, Gg, Gg, Gg, Gg, Gg^Ve, _off^_usr, _off^_usr, _off^_usr, _off^_usr, _off^_usr, _off^_usr, _off^_usr
_off^_usr, _off^_usr, _off^_usr, _off^_usr, _off^_usr, _off^_usr, Gs^Fms, Gs^Fms, Hh, Hh, Gg, Gg, Gg, Gg, Gg^Ve, Gs^Fds, Mm, Hh, Hh, Gg, Gg, Gs^Fds, Gs^Fds, Gs^Fds, Wwg, Gg, _off^_usr, Gg, Wwg, Gs^Fds, Gs^Fds, Gs^Fds, Gg, Gg, Hh, Hh, Mm, Gs^Fds, Gg^Ve, Gg, Gg, Gg, Gg, Hh, Hh, Gs^Fms, Gs^Fms, _off^_usr, _off^_usr, _off^_usr, _off^_usr, _off^_usr, _off^_usr, _off^_usr
_off^_usr, _off^_usr, _off^_usr, _off^_usr, _off^_usr, _off^_usr, Gs^Fms, Gs^Fms, Hh, Gs^Fms, Gg, Gg, Gs^Fds, Gs^Fds, Hh, Hh, Mm, Hh, Mm, Hh, Gg^Ve, Gg, Wwf, Wwf, Gg, Gg, _off^_usr, Gg, Gg, Wwf, Wwf, Gg, Gg^Ve, Hh, Mm, Hh, Mm, Hh, Hh, Gs^Fds, Gs^Fds, Gg, Gg, Gs^Fms, Hh, Gs^Fms, Gs^Fms, _off^_usr, _off^_usr, _off^_usr, _off^_usr, _off^_usr, _off^_usr, _off^_usr
_off^_usr, _off^_usr, _off^_usr, _off^_usr, _off^_usr, _off^_usr, Gg, Hh, Gs^Fms, Gs^Fms, Wwg, Wwg, Wwg, Hh, Gs^Fms, Hh, Gs^Fms, Gs^Fms, Hh, Hh, Gs^Fds, Gs^Fds, Wwg, Gg, Gs^Fds, Gs^Fms, _off^_usr, Gs^Fms, Gs^Fds, Gg, Wwg, Gs^Fds, Gs^Fds, Hh, Hh, Gs^Fms, Gs^Fms, Hh, Gs^Fms, Hh, Wwg, Wwg, Wwg, Gs^Fms, Gs^Fms, Hh, Gg, _off^_usr, _off^_usr, _off^_usr, _off^_usr, _off^_usr, _off^_usr, _off^_usr
_off^_usr, _off^_usr, _off^_usr, _off^_usr, _off^_usr, _off^_usr, Gg, Gg, Wwg, Wwg, Gs^Fds, Wwg, Wwg, Gs^Fds, Wwg, Gs^Fms, Wwf, Hh, Wwf, Wwf, Wwf, Gs^Fds, Wwg, Gg, Gs^Fds, Gs^Fms, _off^_usr, Gs^Fms, Gs^Fds, Gg, Wwg, Gs^Fds, Wwf, Wwf, Wwf, Hh, Wwf, Gs^Fms, Wwg, Gs^Fds, Wwg, Wwg, Gs^Fds, Wwg, Wwg, Gg, Gg, _off^_usr, _off^_usr, _off^_usr, _off^_usr, _off^_usr, _off^_usr, _off^_usr
_off^_usr, _off^_usr, _off^_usr, _off^_usr, _off^_usr, _off^_usr, Gg, Wwg, Wwg, Gs^Fds, Wwg, Wwg, Wwg, Wwg, Hh, Wwg, Hh, Wwf, Wwf, Gs^Fms, Gs^Fms, Wwg, Gg, Gg, Gs^Fds, Hh, _off^_usr, Hh, Gs^Fds, Gg, Gg, Wwg, Gs^Fms, Gs^Fms, Wwf, Wwf, Hh, Wwg, Hh, Wwg, Wwg, Wwg, Wwg, Gs^Fds, Wwg, Wwg, Gg, _off^_usr, _off^_usr, _off^_usr, _off^_usr, _off^_usr, _off^_usr, _off^_usr
_off^_usr, _off^_usr, _off^_usr, _off^_usr, _off^_usr, _off^_usr, Gg, Gg, Gg, Wwg, Wwg, Wwg, Wwg, Wwg, Hh, Hh, Hh, Gs^Fms, Wwg, Hh, Gg, Gg, Gg, Gg, Gg, Hh, _off^_usr, Hh, Gg, Gg, Gg, Gg, Gg, Hh, Wwg, Gs^Fms, Hh, Hh, Hh, Wwg, Wwg, Wwg, Wwg, Wwg, Gg, Gg, Gg, _off^_usr, _off^_usr, _off^_usr, _off^_usr, _off^_usr, _off^_usr, _off^_usr
_off^_usr, _off^_usr, _off^_usr, _off^_usr, _off^_usr, _off^_usr, Gd, Gs^Fds, Gg, Wwg, Wwg, Wwg, Wwg, Hh, Hh^Vhh, Mm, Gg^Fet, Wwg, Wwg, Wwg, Gg, Hh, Hh, Gs^Fds, Gs^Fds, Gg, _off^_usr, Gg, Gs^Fds, Gs^Fds, Hh, Hh, Gg, Wwg, Wwg, Wwg, Gg^Fet, Mm, Hh^Vhh, Hh, Wwg, Wwg, Wwg, Wwg, Gg, Gs^Fds, Gd, _off^_usr, _off^_usr, _off^_usr, _off^_usr, _off^_usr, _off^_usr, _off^_usr
_off^_usr, _off^_usr, _off^_usr, _off^_usr, _off^_usr, _off^_usr, Gd, Gs^Fds, Gs^Fds, Gg, Gg, Gg, Gg, Gg, Gs^Fms, Gs^Fds, Hh, Wwg, Gs^Fms, Gg, Gg, Hh, Mm, Hh, Hh, Gg, _off^_usr, Gg, Hh, Hh, Mm, Hh, Gg, Gg, Gs^Fms, Wwg, Hh, Gs^Fds, Gs^Fms, Gg, Gg, Gg, Gg, Gg, Gs^Fds, Gs^Fds, Gd, _off^_usr, _off^_usr, _off^_usr, _off^_usr, _off^_usr, _off^_usr, _off^_usr
_off^_usr, _off^_usr, _off^_usr, _off^_usr, _off^_usr, _off^_usr, Rd, Gd, Gd, Gg, Gs^Fms, Gg, Gg, Gs^Fms, Gs^Fms, Hh, Gs^Fms, Gs^Fms, Cv, Cv, Cv, Gs^Fds, Gs^Fds, Mm, Hh, Gs^Fds, _off^_usr, Gs^Fds, Hh, Mm, Gs^Fds, Gs^Fds, Cv, Cv, Cv, Gs^Fms, Gs^Fms, Hh, Gs^Fms, Gs^Fms, Gg, Gg, Gs^Fms, Gg, Gd, Gd, Rd, _off^_usr, _off^_usr, _off^_usr, _off^_usr, _off^_usr, _off^_usr, _off^_usr
_off^_usr, _off^_usr, _off^_usr, _off^_usr, _off^_usr, _off^_usr, Qlf, Rd, Rd, Gd, Gd, Gg, Gs^Fms, Gg, Gg, Hh, Hh, Gs^Fms, Gg, Kv, Cv, Cv, Hh, Hh, Gs^Fds, Gs^Fds, _off^_usr, Gs^Fds, Gs^Fds, Hh, Hh, Cv, Cv, Kv, Gg, Gs^Fms, Hh, Hh, Gg, Gg, Gs^Fms, Gg, Gd, Gd, Rd, Rd, Qlf, _off^_usr, _off^_usr, _off^_usr, _off^_usr, _off^_usr, _off^_usr, _off^_usr
_off^_usr, _off^_usr, _off^_usr, _off^_usr, _off^_usr, _off^_usr, Qlf, Mv, Rd, Rd, Gd^Fetd, Gd, Gd, Gg, Gs^Fms, Gg, Gg, Gg, Gg, Gg, Gg, Gg, Gg, Gs^Vl, Gg, Gg, _off^_usr, Gg, Gg, Gs^Vl, Gg, Gg, Gg, Gg, Gg, Gg, Gg, Gg, Gs^Fms, Gg, Gd, Gd, Gd^Fetd, Rd, Rd, Mv, Qlf, _off^_usr, _off^_usr, _off^_usr, _off^_usr, _off^_usr, _off^_usr, _off^_usr
_off^_usr, _off^_usr, _off^_usr, _off^_usr, _off^_usr, _off^_usr, Qlf, Qlf, Mv, Rd, Rd, Gd, Gd, Gs^Fds, Gs^Fms, Gs^Fms, Gg, Gg, Gs^Fds, Gs^Fms, Gg, Gg, Gg, Gg, Gs^Fms, Gg, _off^_usr, Gg, Gs^Fms, Gg, Gg, Gg, Gg, Gs^Fms, Gs^Fds, Gg, Gg, Gs^Fms, Gs^Fms, Gs^Fds, Gd, Gd, Rd, Rd, Mv, Qlf, Qlf, _off^_usr, _off^_usr, _off^_usr, _off^_usr, _off^_usr, _off^_usr, _off^_usr
_off^_usr, _off^_usr, _off^_usr, _off^_usr, _off^_usr, _off^_usr, Qlf, Qlf, Qlf, Rd, Mv, Rd, Gd^Fetd, Gd, Gd, Gs, Gd, Gd, Gd, Gs^Fds, Gd, Gg, Gg, Gs^Fms, Gs, Gs^Fms, _off^_usr, Gs^Fms, Gs, Gs^Fms, Gg, Gg, Gd, Gs^Fds, Gd, Gd, Gd, Gs, Gd, Gd, Gd^Fetd, Rd, Mv, Rd, Qlf, Qlf, Qlf, _off^_usr, _off^_usr, _off^_usr, _off^_usr, _off^_usr, _off^_usr, _off^_usr
_off^_usr, _off^_usr, _off^_usr, _off^_usr, _off^_usr, _off^_usr, Qlf, Qlf, Qlf, Qlf, Qlf, Rd, Rd, Rd, Rd, Gd, Gs, Gs, Gs, Gs, Gd, Gd, Gd, Gd, Rd, Re, _off^_usr, Re, Rd, Gd, Gd, Gd, Gd, Gs, Gs, Gs, Gs, Gd, Rd, Rd, Rd, Rd, Qlf, Qlf, Qlf, Qlf, Qlf, _off^_usr, _off^_usr, _off^_usr, _off^_usr, _off^_usr, _off^_usr, _off^_usr
Qlf, Qlf, Qlf, Qlf, Qlf, Qlf, Qlf, Qlf, Qlf, Qlf, Qlf, Qlf, Qlf, Qlf, Qlf, Qlf, Qlf, Qlf, Qlf, Qlf, Qlf, Qlf, Qlf, Qlf, Qlf, Qlf, _off^_usr, Qlf, Qlf, Qlf, Qlf, Qlf, Qlf, Qlf, Qlf, Qlf, Qlf, Qlf, Qlf, Qlf, Qlf, Qlf, Qlf, Qlf, Qlf, Qlf, Qlf, Qlf, Qlf, Qlf, Qlf, Qlf, Qlf, Qlf
Qlf, Qlf, Qlf, Qlf, Qlf, Qlf, Qlf, Qlf, Qlf, Qlf, Qlf, Qlf, Qlf, Qlf, Qlf, Qlf, Qlf, Qlf, Qlf, Qlf, Qlf, Qlf, Qlf, Qlf, Qlf, Qlf, _off^_usr, Qlf, Qlf, Qlf, Qlf, Qlf, Qlf, Qlf, Qlf, Qlf, Qlf, Qlf, Qlf, Qlf, Qlf, Qlf, Qlf, Qlf, Qlf, Qlf, Qlf, Qlf, Qlf, Qlf, Qlf, Qlf, Qlf, Qlf
Qlf, Qlf, Qlf, Qlf, Qlf, Qlf, Qlf, Qlf, Qlf, Qlf, Qlf, Qlf, Qlf, Qlf, Qlf, Qlf, Qlf, Qlf, Qlf, Qlf, Qlf, Qlf, Qlf, Qlf, Qlf, Qlf, _off^_usr, Qlf, Qlf, Qlf, Qlf, Qlf, Qlf, Qlf, Qlf, Qlf, Qlf, Qlf, Qlf, Qlf, Qlf, Qlf, Qlf, Qlf, Qlf, Qlf, Qlf, Qlf, Qlf, Qlf, Qlf, Qlf, Qlf, Qlf
