Xv, Xv, Xv, Xv, Xv, Xv, Xv, Xv, Xv, Xv, Xv, Xv, Xv, Xv, Xv, Xv, Xv, Xv, Xv, Xv, Xv, Xv, Xv, Xv, Xv, Xv, Xv, Xv, Xv, Xv, Xv, Xv, Xv, Xv, Xv, Xv, Xv, Xv, Xv, Xv, Xv, Xv, Xv, Xv, Xv, Xv, Xv, Xv, Xv, Xv, Xv, Xv, Xv, Xv, Xv, Xv, Xv, Xv, Xv
Xv, Xv, Xv, Xv, Xv, Xv, Xv, Xv, Xv, Xv, Xv, Xv, Xv, Xv, Xv, Xv, Xv, Xv, Xv, Xv, Xv, Xv, Xv, Xv, Xv, Xv, Xv, Xv, Xv, Xv, Xv, Xv, Xv, Xv, Xv, Xv, Xv, Xv, Xv, Xv, Xv, Xv, Xv, Xv, Xv, Xv, Xv, Xv, Xv, Xv, Xv, Xv, Xv, Xv, Xv, Xv, Xv, Xv, Xv
Xv, Xv, Xv, Xv, Xv, Xv, Xv, Xv, Xv, Xv, Xv, Xv, Xv, Xv, Xv, Xv, Xv, Xv, Xv, Xv, Xv, Xv, Xv, Xv, Xv, Xv, Xv, Xv, Xv, Xv, Xv, Xv, Xv, Xv, Xv, Xv, Xv, Xv, Xv, Xv, Xv, Xv, Xv, Xv, Xv, Xv, Xv, Xv, Xv, Xv, Xv, Xv, Xv, Xv, Xv, Xv, Xv, Xv, Xv
Xv, Xv, Xv, Xv, Xv, Xv, Xv, Xv, Xv, Xv, Xv, Xv, Xv, Xv, Xv, Xv, Xv, Xv, Xv, Xv, Xv, Xv, Xv, Xv, Xv, Xv, Xv, Xv, Xv, Xv, Xv, Xv, Xv, Xv, Xv, Xv, Xv, Xv, Xv, Xv, Xv, Xv, Xv, Xv, Xv, Xv, Xv, Xv, Xv, Xv, Xv, Xv, Xv, Xv, Xv, Xv, Xv, Xv, Xv
_off^_usr, _off^_usr, _off^_usr, _off^_usr, _off^_usr, Ss, Wwf, Wwf, Ss, Ss, Wwf, Wwf, Mm^Xm, Mm^Xm, Ms, Mm^Xm, Mm^Xm, Hh, Ss, Gll^Ftr, Ss, Qxu, Qxu, Gll^Ftr, Gll^Ftr, Ss, Rb, Gll^Ftr, Ss, Gll^Ftr, Ss, Gll^Ftr, Rb, Ss, Gll^Ftr, Gll^Ftr, Qxu, Qxu, Ss, Gll^Ftr, Ss, Hh, Mm^Xm, Mm^Xm, Ms, Mm^Xm, Mm^Xm, Wwf, Wwf, Ss, Ss, Wwf, Wwf, Ss, _off^_usr, _off^_usr, _off^_usr, _off^_usr, _off^_usr
_off^_usr, _off^_usr, _off^_usr, _off^_usr, _off^_usr, Gll^Ftr, Wwf, Ss, Ss, Ss, Gll^Ftr, Wwrt, Mm^Xm, Ms, Ms, Ms, Ms, Mm^Xm, Mm^Xm, Ss, Ss, Ss, Ss, Ss^Vhs, Ss, Rb, Rb, Gll^Ftr, Ss, Ss, Ss, Gll^Ftr, Rb, Rb, Ss, Ss^Vhs, Ss, Ss, Ss, Ss, Mm^Xm, Mm^Xm, Ms, Ms, Ms, Ms, Mm^Xm, Wwrt, Gll^Ftr, Ss, Ss, Ss, Wwf, Gll^Ftr, _off^_usr, _off^_usr, _off^_usr, _off^_usr, _off^_usr
_off^_usr, _off^_usr, _off^_usr, _off^_usr, _off^_usr, Gll^Ftr, Ss, Wwf, Ss, Gll^Ftr, Gll^Ftr, Gll^Ftr, Mm^Xm, Ms, Ms, Ms, Ms, Ms, Mm^Xm, Mm^Xm, Hh^Vhh, Hh, Wwrg, Ss, Gll^Ftr, Ss, Ss, Ss^Bw\, Wwf, Wwrg, Wwf, Ss^Bw/, Ss, Ss, Gll^Ftr, Ss, Wwrg, Hh, Hh^Vhh, Mm^Xm, Mm^Xm, Ms, Ms, Ms, Ms, Ms, Mm^Xm, Gll^Ftr, Gll^Ftr, Gll^Ftr, Ss, Wwf, Ss, Gll^Ftr, _off^_usr, _off^_usr, _off^_usr, _off^_usr, _off^_usr
_off^_usr, _off^_usr, _off^_usr, _off^_usr, _off^_usr, Gll^Ftr, Wwrg, Wwf, Rb, Ss, Gll^Ftr, Ss, Mm^Xm, Ms, Ms, Ms, Mm^Xm, Mm^Xm, Hh, Hh, Mm, Wwrg, Mm, Wwg, Wwg, Gll^Ftr, Wwf, Wwf, Wwf, Wwf, Wwf, Wwf, Wwf, Gll^Ftr, Wwg, Wwg, Mm, Wwrg, Mm, Hh, Hh, Mm^Xm, Mm^Xm, Ms, Ms, Ms, Mm^Xm, Ss, Gll^Ftr, Ss, Rb, Wwf, Wwrg, Gll^Ftr, _off^_usr, _off^_usr, _off^_usr, _off^_usr, _off^_usr
_off^_usr, _off^_usr, _off^_usr, _off^_usr, _off^_usr, Wwg, Wwg, Wwf, Wwf, Rb, Rb, Ss, Ss, Mm^Xm, Mm^Xm, Mm^Xm, Gll^Ftr, Ss, Gll^Ftr, Ss, Ss, Hh, Ss, Ss, Ss, Wwf, Wwrg, Wwg, Wwf, Wwf, Wwf, Wwg, Wwrg, Wwf, Ss, Ss, Ss, Hh, Ss, Ss, Gll^Ftr, Ss, Gll^Ftr, Mm^Xm, Mm^Xm, Mm^Xm, Ss, Ss, Rb, Rb, Wwf, Wwf, Wwg, Wwg, _off^_usr, _off^_usr, _off^_usr, _off^_usr, _off^_usr
_off^_usr, _off^_usr, _off^_usr, _off^_usr, _off^_usr, Wwg, Wwrg, Wwf, Wwf, Ss, Gll^Ftr, Rb, Rb, Ss, Ss, Ss, Ss, Ss, Hh, Gll^Ftr, Gll^Ftr, Ss, Gll^Ftr, Wwrg, Wwf, Wwf, Wwf, Wwg, Wwf, Wwf, Wwf, Wwg, Wwf, Wwf, Wwf, Wwrg, Gll^Ftr, Ss, Gll^Ftr, Gll^Ftr, Hh, Ss, Ss, Ss, Ss, Ss, Rb, Rb, Gll^Ftr, Ss, Wwf, Wwf, Wwrg, Wwg, _off^_usr, _off^_usr, _off^_usr, _off^_usr, _off^_usr
_off^_usr, _off^_usr, _off^_usr, _off^_usr, _off^_usr, Wwg, Wwg, Wwrg, Wwf, Wwf, Ss, Gll^Ftr, Ss, Ss^Bw\, Khs, Chs, Ss^Bw/, Ss^Bw/, Ss, Hh, Gll^Ftr, Ss, Gll^Ftr, Wwf, Wwf, Gll^Ftr, Gll^Ftr, Wwf, Ss^Bw\r, Gll^Ftr, Ss^Bw/r, Wwf, Gll^Ftr, Gll^Ftr, Wwf, Wwf, Gll^Ftr, Ss, Gll^Ftr, Hh, Ss, Ss^Bw\, Ss^Bw\, Chs, Khs, Ss^Bw/, Ss, Gll^Ftr, Ss, Wwf, Wwf, Wwrg, Wwg, Wwg, _off^_usr, _off^_usr, _off^_usr, _off^_usr, _off^_usr
_off^_usr, _off^_usr, _off^_usr, _off^_usr, _off^_usr, Wwg, Wwf, Wwf, Wwf, Gll^Ftr, Ss, Ss, Ss, Chs, Chs, Chs, Ss^Bw\, Ss, Wwf, Hh, Wwf, Wwf, Wwf, Gll^Ftr, Wwf, Wwf, Ss, Ss^Vhs, Chs, Khs, Chs, Ss^Vhs, Ss, Wwf, Wwf, Gll^Ftr, Wwf, Wwf, Wwf, Hh, Wwf, Ss, Ss^Bw/, Chs, Chs, Chs, Ss, Ss, Ss, Gll^Ftr, Wwf, Wwf, Wwf, Wwg, _off^_usr, _off^_usr, _off^_usr, _off^_usr, _off^_usr
_off^_usr, _off^_usr, _off^_usr, _off^_usr, _off^_usr, Wwg, Wwf, Wwf, Gll^Ftr, Ss, Hh, Hh, Gll^Ftr, Ss^Vhs, Ss^Vhs, Chs, Ss, Wwf^Bw\, Wwf^Bw|, Wwf, Gll^Ftr, Ss, Ss, Wwf, Wwg, Gll^Ftr, Gll^Ftr, Gll^Ftr, Chs, Chs, Chs, Gll^Ftr, Gll^Ftr, Gll^Ftr, Wwg, Wwf, Ss, Ss, Gll^Ftr, Wwf, Wwf^Bw|, Wwf^Bw/, Ss, Chs, Ss^Vhs, Ss^Vhs, Gll^Ftr, Hh, Hh, Ss, Gll^Ftr, Wwf, Wwf, Wwg, _off^_usr, _off^_usr, _off^_usr, _off^_usr, _off^_usr
_off^_usr, _off^_usr, _off^_usr, _off^_usr, _off^_usr, Wwg, Hh, Wwf, Hh, Hh, Hh, Gll^Ftr, Gll^Ftr, Ss, Wwf, Ss, Wwf, Wwf, Hh, Ss, Ss, Gll^Ftr, Ss, Wwf, Ss, Ss, Ss, Gll^Ftr, Hh, Hh, Hh, Gll^Ftr, Ss, Ss, Ss, Wwf, Ss, Gll^Ftr, Ss, Ss, Hh, Wwf, Wwf, Ss, Wwf, Ss, Gll^Ftr, Gll^Ftr, Hh, Hh, Hh, Wwf, Hh, Wwg, _off^_usr, _off^_usr, _off^_usr, _off^_usr, _off^_usr
_off^_usr, _off^_usr, _off^_usr, _off^_usr, _off^_usr, Wwg, Wwf, Wwf, Hh, Hh, Wwf, Wwf, Wwf, Wwf, Ss, Wwf, Wwf, Gll^Ftr, Hh, Ss, Gll^Ftr, Ss, Wwf, Wwf, Ss, Ss, Gll^Ftr, Hh, Hh, Hh, Hh, Hh, Gll^Ftr, Ss, Ss, Wwf, Wwf, Ss, Gll^Ftr, Ss, Hh, Gll^Ftr, Wwf, Wwf, Ss, Wwf, Wwf, Wwf, Wwf, Hh, Hh, Wwf, Wwf, Wwg, _off^_usr, _off^_usr, _off^_usr, _off^_usr, _off^_usr
_off^_usr, _off^_usr, _off^_usr, _off^_usr, _off^_usr, Hh, Wwf, Hh, Mm, Mm, Wwf, Ss, Ss, Wwf, Mm, Ss, Wwf, Gll^Ftr, Md, Md, Hh, Hh, Wwf, Wwf, Mm, Mm, Mm, Gll^Ftr, Hh, Hh, Hh, Gll^Ftr, Mm, Mm, Mm, Wwf, Wwf, Hh, Hh, Md, Md, Gll^Ftr, Wwf, Ss, Mm, Wwf, Ss, Ss, Wwf, Mm, Mm, Hh, Wwf, Hh, _off^_usr, _off^_usr, _off^_usr, _off^_usr, _off^_usr
_off^_usr, _off^_usr, _off^_usr, _off^_usr, _off^_usr, Mm, Mm, Hh, Hh, Hh, Hh, Wwf, Wwf, Mm, Wwf, Md, Wwf, Hh, Hh, Hh, Wwf, Wwf, Mm, Wwf, Mm, Mm, Mm, Hh, Mm, Mm, Mm, Hh, Mm, Mm, Mm, Wwf, Mm, Wwf, Wwf, Hh, Hh, Hh, Wwf, Md, Wwf, Mm, Wwf, Wwf, Hh, Hh, Hh, Hh, Mm, Mm, _off^_usr, _off^_usr, _off^_usr, _off^_usr, _off^_usr
_off^_usr, _off^_usr, _off^_usr, _off^_usr, _off^_usr, Mm, Mm^Xm, Hh, Mm^Xm, Mm^Xm, Hhd, Hh, Md, Wwf, Md, Md, Hh, Hh, Md, Wwf, Hh, Mm, Hh, Hh, Hh, Hh, Hh, Hh, Mm, Mm, Mm, Hh, Hh, Hh, Hh, Hh, Hh, Mm, Hh, Wwf, Md, Hh, Hh, Md, Md, Wwf, Md, Hh, Hhd, Mm^Xm, Mm^Xm, Hh, Mm^Xm, Mm, _off^_usr, _off^_usr, _off^_usr, _off^_usr, _off^_usr
_off^_usr, _off^_usr, _off^_usr, _off^_usr, _off^_usr, _off^_usr, Mm^Xm, Mm^Xm, Mm^Xm, Mm^Xm, Hhd, Mm, Hhd, Hhd, Hhd, Hhd, Md, Hhd, Gll^Fdw, Hhd, Gll^Fdw, Mm, Mm, Hhd, Mm^Xm, Mm^Xm, Mm^Xm, Mm^Xm, Mm^Xm, Md^Xm, Mm^Xm, Mm^Xm, Mm^Xm, Mm^Xm, Mm^Xm, Hhd, Mm, Mm, Gll^Fdw, Hhd, Gll^Fdw, Hhd, Md, Hhd, Hhd, Hhd, Hhd, Md, Hhd, Mm^Xm, Mm^Xm, Mm^Xm, Mm^Xm, _off^_usr, _off^_usr, _off^_usr, _off^_usr, _off^_usr, _off^_usr
Qlf, Qlf, Qlf, Qlf, Qlf, Qlf, Qlf, Qlf, Qlf, Qlf, Qlf, Qlf, Qlf, Qlf, Qlf, Qlf, Qlf, Qlf, Qlf, Qlf, Qlf, Qlf, Qlf, Qlf, Qlf, Qlf, Qlf, Qlf, Qlf, Qlf, Qlf, Qlf, Qlf, Qlf, Qlf, Qlf, Qlf, Qlf, Qlf, Qlf, Qlf, Qlf, Qlf, Qlf, Qlf, Qlf, Qlf, Qlf, Qlf, Qlf, Qlf, Qlf, Qlf, Qlf, Qlf, Qlf, Qlf, Qlf, Qlf
Qlf, Qlf, Qlf, Qlf, Qlf, Qlf, Qlf, Qlf, Qlf, Qlf, Qlf, Qlf, Qlf, Qlf, Qlf, Qlf, Qlf, Qlf, Qlf, Qlf, Qlf, Qlf, Qlf, Qlf, Qlf, Qlf, Qlf, Qlf, Qlf, Qlf, Qlf, Qlf, Qlf, Qlf, Qlf, Qlf, Qlf, Qlf, Qlf, Qlf, Qlf, Qlf, Qlf, Qlf, Qlf, Qlf, Qlf, Qlf, Qlf, Qlf, Qlf, Qlf, Qlf, Qlf, Qlf, Qlf, Qlf, Qlf, Qlf
Qlf, Qlf, Qlf, Qlf, Qlf, Qlf, Qlf, Qlf, Qlf, Qlf, Qlf, Qlf, Qlf, Qlf, Qlf, Qlf, Qlf, Qlf, Qlf, Qlf, Qlf, Qlf, Qlf, Qlf, Qlf, Qlf, Qlf, Qlf, Qlf, Qlf, Qlf, Qlf, Qlf, Qlf, Qlf, Qlf, Qlf, Qlf, Qlf, Qlf, Qlf, Qlf, Qlf, Qlf, Qlf, Qlf, Qlf, Qlf, Qlf, Qlf, Qlf, Qlf, Qlf, Qlf, Qlf, Qlf, Qlf, Qlf, Qlf
