border_size=1
usage=map

Xv, Xv, Xv, Xv, Xv, Xv, Xv, Xv, Xv, Xv, Xv, Xv, Xv, Xv, Xv, Xv, Xv, Xv, Xv, Xv, Xv, Xv, Xv, Xv, Xv, Xv, Xv, Xv, Xv, Xv, Xv, Xv, Xv, Xv, Xv, Xv, Xv, Xv, Xv, Xv, Xv, Xv, Xv, Xv, Xv, Xv, Xv, Xv, Xv, Xv, Xv, Xv
Xv, 1 Xv, Xv, Xv, Xv, Xv, Xv, Xv, Xv, Xv, Xv, Xv, Xv, Xv, Xv, Xv, Xv, Xv, Xv, Xv, Xv, Xv, Xv, Xv, Xv, Xv, 7 Xv, Xv, Xv, Xv, Xv, Xv, Xv, Xv, Xv, Xv, Xv, Xv, Xv, Xv, Xv, Xv, Xv, Xv, Xv, Xv, Xv, Xv, Xv, Xv, 4 Xv, Xv
Xv, 2 Xv, Xv, Xv, Xv, Xv, Xv, Xv, Xv, Xv, Xv, Xv, Xv, Xv, Xv, Xv, Xv, Xv, Xv, Xv, Xv, Xv, Xv, Xv, Xv, Xv, Xv, Xv, Xv, Xv, Xv, Xv, Xv, Xv, Xv, Xv, Xv, Xv, Xv, Xv, Xv, Xv, Xv, Xv, Xv, Xv, Xv, Xv, Xv, Xv, 5 Xv, Xv
Xv, 3 Xv, Xv, Xv, Xv, Xv, Xv, Xv, Xv, Xv, Xv, Xv, Xv, Xv, Xv, Xv, Xv, Xv, Xv, Xv, Xv, Xv, Xv, Xv, Xv, Xv, Xv, Xv, Xv, Xv, Xv, Xv, Xv, Xv, Xv, Xv, Xv, Xv, Xv, Xv, Xv, Xv, Xv, Xv, Xv, Xv, Xv, Xv, Xv, Xv, 6 Xv, Xv
_off^_usr, _off^_usr, _off^_usr, _off^_usr, _off^_usr, _off^_usr, _off^_usr, _off^_usr, _off^_usr, _off^_usr, _off^_usr, _off^_usr, _off^_usr, _off^_usr, _off^_usr, _off^_usr, _off^_usr, _off^_usr, _off^_usr, Dd^Do, Wwf, Wwf, Re, Re, Dd, Dd, Hd, Dd, Dd, Re, Re, Wwf, Wwf, Dd^Do, _off^_usr, _off^_usr, _off^_usr, _off^_usr, _off^_usr, _off^_usr, _off^_usr, _off^_usr, _off^_usr, _off^_usr, _off^_usr, _off^_usr, _off^_usr, _off^_usr, _off^_usr, _off^_usr, _off^_usr, _off^_usr
_off^_usr, _off^_usr, _off^_usr, _off^_usr, _off^_usr, _off^_usr, _off^_usr, _off^_usr, _off^_usr, _off^_usr, _off^_usr, _off^_usr, _off^_usr, _off^_usr, _off^_usr, _off^_usr, _off^_usr, _off^_usr, _off^_usr, Wwf, Gs^Ft, Hd, Re, Re, Dd, Dd, Dd, Dd, Dd, Re, Re, Hd, Gs^Ft, Wwf, _off^_usr, _off^_usr, _off^_usr, _off^_usr, _off^_usr, _off^_usr, _off^_usr, _off^_usr, _off^_usr, _off^_usr, _off^_usr, _off^_usr, _off^_usr, _off^_usr, _off^_usr, _off^_usr, _off^_usr, _off^_usr
_off^_usr, _off^_usr, _off^_usr, _off^_usr, _off^_usr, _off^_usr, _off^_usr, _off^_usr, _off^_usr, _off^_usr, _off^_usr, _off^_usr, _off^_usr, _off^_usr, _off^_usr, _off^_usr, _off^_usr, _off^_usr, _off^_usr, Gs^Ft, Dd, Dd, Re, Dd, Dd, Dd, Hd, Dd, Dd, Dd, Re, Dd, Dd, Gs^Ft, _off^_usr, _off^_usr, _off^_usr, _off^_usr, _off^_usr, _off^_usr, _off^_usr, _off^_usr, _off^_usr, _off^_usr, _off^_usr, _off^_usr, _off^_usr, _off^_usr, _off^_usr, _off^_usr, _off^_usr, _off^_usr
_off^_usr, _off^_usr, _off^_usr, _off^_usr, _off^_usr, _off^_usr, _off^_usr, _off^_usr, _off^_usr, _off^_usr, _off^_usr, _off^_usr, _off^_usr, _off^_usr, _off^_usr, _off^_usr, _off^_usr, _off^_usr, _off^_usr, Dd, Hd, Hd, Re, Dd, Hd, Dd^Vdt, Dd^Ftd, Dd^Vdt, Hd, Dd, Re, Hd, Hd, Dd, _off^_usr, _off^_usr, _off^_usr, _off^_usr, _off^_usr, _off^_usr, _off^_usr, _off^_usr, _off^_usr, _off^_usr, _off^_usr, _off^_usr, _off^_usr, _off^_usr, _off^_usr, _off^_usr, _off^_usr, _off^_usr
_off^_usr, _off^_usr, _off^_usr, _off^_usr, _off^_usr, _off^_usr, _off^_usr, _off^_usr, _off^_usr, _off^_usr, _off^_usr, _off^_usr, _off^_usr, _off^_usr, _off^_usr, _off^_usr, _off^_usr, _off^_usr, _off^_usr, Md, Hd, Dd, Re, Dd, Dd, Dd^Do, Dd, Dd^Do, Dd, Dd, Re, Dd, Hd, Md, _off^_usr, _off^_usr, _off^_usr, _off^_usr, _off^_usr, _off^_usr, _off^_usr, _off^_usr, _off^_usr, _off^_usr, _off^_usr, _off^_usr, _off^_usr, _off^_usr, _off^_usr, _off^_usr, _off^_usr, _off^_usr
_off^_usr, _off^_usr, _off^_usr, _off^_usr, _off^_usr, _off^_usr, _off^_usr, _off^_usr, _off^_usr, _off^_usr, _off^_usr, _off^_usr, _off^_usr, _off^_usr, Xu, Xu, Xu, Xu, Xu, Dd, Hd, Hd, Re, Ce, Hd, Dd, Rd, Dd, Hd, Ce, Re, Hd, Hd, Dd, Xu, Xu, Xu, Xu, Xu, _off^_usr, _off^_usr, _off^_usr, _off^_usr, _off^_usr, _off^_usr, _off^_usr, _off^_usr, _off^_usr, _off^_usr, _off^_usr, _off^_usr, _off^_usr
_off^_usr, _off^_usr, _off^_usr, _off^_usr, _off^_usr, _off^_usr, _off^_usr, _off^_usr, _off^_usr, _off^_usr, _off^_usr, _off^_usr, _off^_usr, Xu, Xu, Xu, Xu, Xu, Uh, Xu, Xu, Re, Re, Re, Re, Dd, Xu, Dd, Re, Re, Re, Re, Xu, Xu, Uh, Xu, Xu, Xu, Xu, Xu, _off^_usr, _off^_usr, _off^_usr, _off^_usr, _off^_usr, _off^_usr, _off^_usr, _off^_usr, _off^_usr, _off^_usr, _off^_usr, _off^_usr
_off^_usr, _off^_usr, _off^_usr, _off^_usr, _off^_usr, _off^_usr, _off^_usr, _off^_usr, _off^_usr, _off^_usr, _off^_usr, _off^_usr, Xu, Xu, Xu, Uu^Uf, Uu, Xu, Uu, Uu^Uf, Uh, Uu, Ur, Re, Xu, Xu, Xu, Xu, Xu, Re, Ur, Uu, Uh, Uu^Uf, Uu, Xu, Uu, Uu^Uf, Xu, Xu, Xu, _off^_usr, _off^_usr, _off^_usr, _off^_usr, _off^_usr, _off^_usr, _off^_usr, _off^_usr, _off^_usr, _off^_usr, _off^_usr
_off^_usr, _off^_usr, _off^_usr, _off^_usr, _off^_usr, _off^_usr, _off^_usr, _off^_usr, _off^_usr, _off^_usr, Xu, Xu, Xu, Xu, Ql, Ql, Ql^Bs/, Ur, Ur, Uh, Ur, Ur, Uu, Uu, Uu^Uf, Xu, Xu, Xu, Uu^Uf, Uu, Uu, Ur, Ur, Uh, Ur, Ur, Ql^Bs\, Ql, Ql, Xu, Xu, Xu, Xu, _off^_usr, _off^_usr, _off^_usr, _off^_usr, _off^_usr, _off^_usr, _off^_usr, _off^_usr, _off^_usr
_off^_usr, _off^_usr, _off^_usr, _off^_usr, _off^_usr, _off^_usr, _off^_usr, _off^_usr, _off^_usr, _off^_usr, Xu, Xu, Xu, Uu^Uf, Cud, Ur, Cud, Ql, Cud, Ur, Uh, Ur, Uu^Uf, Uh, Cud, Xu, Cud, Xu, Cud, Uh, Uu^Uf, Ur, Uh, Ur, Cud, Ql, Cud, Ur, Cud, Uu^Uf, Xu, Xu, Xu, _off^_usr, _off^_usr, _off^_usr, _off^_usr, _off^_usr, _off^_usr, _off^_usr, _off^_usr, _off^_usr
_off^_usr, _off^_usr, _off^_usr, _off^_usr, _off^_usr, _off^_usr, _off^_usr, _off^_usr, Xu, Xu, Xu, Xu, Xu, Cud, Ql, Cud, 8 Kud, Cud, Ur, Ql, Ql^Bs/, Ur, Ur, Uu^Uf, Cud, Cud, Kud, Cud, Cud, Uu^Uf, Ur, Ur, Ql^Bs\, Ql, Ur, Cud, 9 Kud, Cud, Ql, Cud, Xu, Xu, Xu, Xu, Xu, _off^_usr, _off^_usr, _off^_usr, _off^_usr, _off^_usr, _off^_usr, _off^_usr
_off^_usr, _off^_usr, _off^_usr, _off^_usr, _off^_usr, _off^_usr, Xu, Xu, Xu, Xu, Xu, Xu, Ql, Ql, Uu, Cud, Uu, Cud, Uu, Cud, Ql, Uu, Uh, Ur, Ur, Cud, Cud, Cud, Ur, Ur, Uh, Uu, Ql, Cud, Uu, Cud, Uu, Cud, Uu, Ql, Ql, Xu, Xu, Xu, Xu, Xu, Xu, _off^_usr, _off^_usr, _off^_usr, _off^_usr, _off^_usr
_off^_usr, _off^_usr, _off^_usr, _off^_usr, Xu, Xu, Xu, Xu, Ql, Ql, Uh, Uu^Uf, Ql, Ql, Ql, Uu, Uu^Uf, Uh, Ql, Uu, Ql^Bs\, Ql, Uu^Uf, Ql, Ql, Ql, Xu, Ql, Ql, Ql, Uu^Uf, Ql, Ql^Bs/, Uu, Ql, Uh, Uu^Uf, Uu, Ql, Ql, Ql, Uu^Uf, Uh, Ql, Ql, Xu, Xu, Xu, Xu, _off^_usr, _off^_usr, _off^_usr
_off^_usr, _off^_usr, _off^_usr, _off^_usr, Xu, Xu, Xu, Uh, Ql, Xu, Xu, Uu, Ql, Uu^Uf, Uh, Ql, Uu, Ql, Uu, Ql, Ql, Uu, Uh, Uu, Ql, Uh, Xu, Uh, Ql, Uu, Uh, Uu, Ql, Ql, Uu, Ql, Uu, Ql, Uh, Uu^Uf, Ql, Uu, Xu, Xu, Ql, Uh, Xu, Xu, Xu, _off^_usr, _off^_usr, _off^_usr
_off^_usr, _off^_usr, Xu, Xu, Xu, Qlf, Xu, Xu, Ql, Ql, Uu, Uh, Uu, Ql, Uu, Ql, Uh, Ql, Uh, Uu^Uf, Ql, Uu, Uu, Uu, Uu, Ql, Xu, Ql, Uu, Uu, Uu, Uu, Ql, Uu^Uf, Uh, Ql, Uh, Ql, Uu, Ql, Uu, Uh, Uu, Ql, Ql, Xu, Xu, Qlf, Xu, Xu, Xu, _off^_usr
_off^_usr, Xu, Xu, Xu, Qlf, Qlf, Qlf, Qlf, Qlf, Qlf, Qlf, Qlf, Qlf, Qlf, Qlf, Qlf, Qlf, Qlf, Qlf, Qlf, Qlf, Qlf, Qlf, Qlf, Qlf, Qlf, Xu, Qlf, Qlf, Qlf, Qlf, Qlf, Qlf, Qlf, Qlf, Qlf, Qlf, Qlf, Qlf, Qlf, Qlf, Qlf, Qlf, Qlf, Qlf, Qlf, Qlf, Qlf, Qlf, Xu, Xu, _off^_usr
Xu, Xu, Qlf, Qlf, Qlf, Qlf, Qlf, Qlf, Qlf, Qlf, Qlf, Qlf, Qlf, Qlf, Qlf, Qlf, Qlf, Qlf, Qlf, Qlf, Qlf, Qlf, Qlf, Qlf, Qlf, Qlf, Xu, Qlf, Qlf, Qlf, Qlf, Qlf, Qlf, Qlf, Qlf, Qlf, Qlf, Qlf, Qlf, Qlf, Qlf, Qlf, Qlf, Qlf, Qlf, Qlf, Qlf, Qlf, Qlf, Qlf, Qlf, Xu
